MASK hermana pequena juega con sus munecas nuevas en la habitacion grande	mi
mi MASK pequena juega con sus munecas nuevas en la habitacion grande	hermana
mi hermana MASK juega con sus munecas nuevas en la habitacion grande	pequena
mi hermana pequena MASK con sus munecas nuevas en la habitacion grande	juega
mi hermana pequena juega MASK sus munecas nuevas en la habitacion grande	con
mi hermana pequena juega con MASK munecas nuevas en la habitacion grande	sus
mi hermana pequena juega con sus MASK nuevas en la habitacion grande	munecas
mi hermana pequena juega con sus munecas MASK en la habitacion grande	nuevas
mi hermana pequena juega con sus munecas nuevas MASK la habitacion grande	en
mi hermana pequena juega con sus munecas nuevas en MASK habitacion grande	la
mi hermana pequena juega con sus munecas nuevas en la MASK grande	habitacion
mi hermana pequena juega con sus munecas nuevas en la habitacion MASK	grande
MASK perro marron corre rapidamente por el parque verde todas las mananas	el
el MASK marron corre rapidamente por el parque verde todas las mananas	perro
el perro MASK corre rapidamente por el parque verde todas las mananas	marron
el perro marron MASK rapidamente por el parque verde todas las mananas	corre
el perro marron corre MASK por el parque verde todas las mananas	rapidamente
el perro marron corre rapidamente MASK el parque verde todas las mananas	por
el perro marron corre rapidamente por MASK parque verde todas las mananas	el
el perro marron corre rapidamente por el MASK verde todas las mananas	parque
el perro marron corre rapidamente por el parque MASK todas las mananas	verde
el perro marron corre rapidamente por el parque verde MASK las mananas	todas
el perro marron corre rapidamente por el parque verde todas MASK mananas	las
el perro marron corre rapidamente por el parque verde todas las MASK	mananas
MASK compre pan fresco y leche entera en el supermercado de la esquina	ayer
ayer MASK pan fresco y leche entera en el supermercado de la esquina	compre
ayer compre MASK fresco y leche entera en el supermercado de la esquina	pan
ayer compre pan MASK y leche entera en el supermercado de la esquina	fresco
ayer compre pan fresco MASK leche entera en el supermercado de la esquina	y
ayer compre pan fresco y MASK entera en el supermercado de la esquina	leche
ayer compre pan fresco y leche MASK en el supermercado de la esquina	entera
ayer compre pan fresco y leche entera MASK el supermercado de la esquina	en
ayer compre pan fresco y leche entera en MASK supermercado de la esquina	el
ayer compre pan fresco y leche entera en el MASK de la esquina	supermercado
ayer compre pan fresco y leche entera en el supermercado MASK la esquina	de
ayer compre pan fresco y leche entera en el supermercado de MASK esquina	la
ayer compre pan fresco y leche entera en el supermercado de la MASK	esquina
MASK ventana de la cocina siempre esta abierta durante los dias calurosos	la
la MASK de la cocina siempre esta abierta durante los dias calurosos	ventana
la ventana MASK la cocina siempre esta abierta durante los dias calurosos	de
la ventana de MASK cocina siempre esta abierta durante los dias calurosos	la
la ventana de la MASK siempre esta abierta durante los dias calurosos	cocina
la ventana de la cocina MASK esta abierta durante los dias calurosos	siempre
la ventana de la cocina siempre MASK abierta durante los dias calurosos	esta
la ventana de la cocina siempre esta MASK durante los dias calurosos	abierta
la ventana de la cocina siempre esta abierta MASK los dias calurosos	durante
la ventana de la cocina siempre esta abierta durante MASK dias calurosos	los
la ventana de la cocina siempre esta abierta durante los MASK calurosos	dias
la ventana de la cocina siempre esta abierta durante los dias MASK	calurosos
MASK padres preparan una deliciosa cena para toda la familia los domingos	mis
mis MASK preparan una deliciosa cena para toda la familia los domingos	padres
mis padres MASK una deliciosa cena para toda la familia los domingos	preparan
mis padres preparan MASK deliciosa cena para toda la familia los domingos	una
mis padres preparan una MASK cena para toda la familia los domingos	deliciosa
mis padres preparan una deliciosa MASK para toda la familia los domingos	cena
mis padres preparan una deliciosa cena MASK toda la familia los domingos	para
mis padres preparan una deliciosa cena para MASK la familia los domingos	toda
mis padres preparan una deliciosa cena para toda MASK familia los domingos	la
mis padres preparan una deliciosa cena para toda la MASK los domingos	familia
mis padres preparan una deliciosa cena para toda la familia MASK domingos	los
mis padres preparan una deliciosa cena para toda la familia los MASK	domingos
MASK gato negro duerme tranquilamente sobre el sofa rojo junto a la chimenea	el
el MASK negro duerme tranquilamente sobre el sofa rojo junto a la chimenea	gato
el gato MASK duerme tranquilamente sobre el sofa rojo junto a la chimenea	negro
el gato negro MASK tranquilamente sobre el sofa rojo junto a la chimenea	duerme
el gato negro duerme MASK sobre el sofa rojo junto a la chimenea	tranquilamente
el gato negro duerme tranquilamente MASK el sofa rojo junto a la chimenea	sobre
el gato negro duerme tranquilamente sobre MASK sofa rojo junto a la chimenea	el
el gato negro duerme tranquilamente sobre el MASK rojo junto a la chimenea	sofa
el gato negro duerme tranquilamente sobre el sofa MASK junto a la chimenea	rojo
el gato negro duerme tranquilamente sobre el sofa rojo MASK a la chimenea	junto
el gato negro duerme tranquilamente sobre el sofa rojo junto MASK la chimenea	a
el gato negro duerme tranquilamente sobre el sofa rojo junto a MASK chimenea	la
el gato negro duerme tranquilamente sobre el sofa rojo junto a la MASK	chimenea
MASK la casa entera cada sabado por la manana con mucha energia	limpiamos
limpiamos MASK casa entera cada sabado por la manana con mucha energia	la
limpiamos la MASK entera cada sabado por la manana con mucha energia	casa
limpiamos la casa MASK cada sabado por la manana con mucha energia	entera
limpiamos la casa entera MASK sabado por la manana con mucha energia	cada
limpiamos la casa entera cada MASK por la manana con mucha energia	sabado
limpiamos la casa entera cada sabado MASK la manana con mucha energia	por
limpiamos la casa entera cada sabado por MASK manana con mucha energia	la
limpiamos la casa entera cada sabado por la MASK con mucha energia	manana
limpiamos la casa entera cada sabado por la manana MASK mucha energia	con
limpiamos la casa entera cada sabado por la manana con MASK energia	mucha
limpiamos la casa entera cada sabado por la manana con mucha MASK	energia
MASK despertador suena muy temprano obligandome a levantarme para ir al trabajo	el
el MASK suena muy temprano obligandome a levantarme para ir al trabajo	despertador
el despertador MASK muy temprano obligandome a levantarme para ir al trabajo	suena
el despertador suena MASK temprano obligandome a levantarme para ir al trabajo	muy
el despertador suena muy MASK obligandome a levantarme para ir al trabajo	temprano
el despertador suena muy temprano MASK a levantarme para ir al trabajo	obligandome
el despertador suena muy temprano obligandome MASK levantarme para ir al trabajo	a
el despertador suena muy temprano obligandome a MASK para ir al trabajo	levantarme
el despertador suena muy temprano obligandome a levantarme MASK ir al trabajo	para
el despertador suena muy temprano obligandome a levantarme para MASK al trabajo	ir
el despertador suena muy temprano obligandome a levantarme para ir MASK trabajo	al
el despertador suena muy temprano obligandome a levantarme para ir al MASK	trabajo
MASK abuela hornea galletas de chocolate con un aroma que inunda la casa	mi
mi MASK hornea galletas de chocolate con un aroma que inunda la casa	abuela
mi abuela MASK galletas de chocolate con un aroma que inunda la casa	hornea
mi abuela hornea MASK de chocolate con un aroma que inunda la casa	galletas
mi abuela hornea galletas MASK chocolate con un aroma que inunda la casa	de
mi abuela hornea galletas de MASK con un aroma que inunda la casa	chocolate
mi abuela hornea galletas de chocolate MASK un aroma que inunda la casa	con
mi abuela hornea galletas de chocolate con MASK aroma que inunda la casa	un
mi abuela hornea galletas de chocolate con un MASK que inunda la casa	aroma
mi abuela hornea galletas de chocolate con un aroma MASK inunda la casa	que
mi abuela hornea galletas de chocolate con un aroma que MASK la casa	inunda
mi abuela hornea galletas de chocolate con un aroma que inunda MASK casa	la
mi abuela hornea galletas de chocolate con un aroma que inunda la MASK	casa
MASK ninos guardan sus juguetes coloridos antes de irse a dormir temprano	los
los MASK guardan sus juguetes coloridos antes de irse a dormir temprano	ninos
los ninos MASK sus juguetes coloridos antes de irse a dormir temprano	guardan
los ninos guardan MASK juguetes coloridos antes de irse a dormir temprano	sus
los ninos guardan sus MASK coloridos antes de irse a dormir temprano	juguetes
los ninos guardan sus juguetes MASK antes de irse a dormir temprano	coloridos
los ninos guardan sus juguetes coloridos MASK de irse a dormir temprano	antes
los ninos guardan sus juguetes coloridos antes MASK irse a dormir temprano	de
los ninos guardan sus juguetes coloridos antes de MASK a dormir temprano	irse
los ninos guardan sus juguetes coloridos antes de irse MASK dormir temprano	a
los ninos guardan sus juguetes coloridos antes de irse a MASK temprano	dormir
los ninos guardan sus juguetes coloridos antes de irse a dormir MASK	temprano
MASK gerente revisa los informes financieros importantes en su oficina cada lunes	el
el MASK revisa los informes financieros importantes en su oficina cada lunes	gerente
el gerente MASK los informes financieros importantes en su oficina cada lunes	revisa
el gerente revisa MASK informes financieros importantes en su oficina cada lunes	los
el gerente revisa los MASK financieros importantes en su oficina cada lunes	informes
el gerente revisa los informes MASK importantes en su oficina cada lunes	financieros
el gerente revisa los informes financieros MASK en su oficina cada lunes	importantes
el gerente revisa los informes financieros importantes MASK su oficina cada lunes	en
el gerente revisa los informes financieros importantes en MASK oficina cada lunes	su
el gerente revisa los informes financieros importantes en su MASK cada lunes	oficina
el gerente revisa los informes financieros importantes en su oficina MASK lunes	cada
el gerente revisa los informes financieros importantes en su oficina cada MASK	lunes
MASK secretaria organiza las reuniones y gestiona la agenda del equipo eficientemente	la
la MASK organiza las reuniones y gestiona la agenda del equipo eficientemente	secretaria
la secretaria MASK las reuniones y gestiona la agenda del equipo eficientemente	organiza
la secretaria organiza MASK reuniones y gestiona la agenda del equipo eficientemente	las
la secretaria organiza las MASK y gestiona la agenda del equipo eficientemente	reuniones
la secretaria organiza las reuniones MASK gestiona la agenda del equipo eficientemente	y
la secretaria organiza las reuniones y MASK la agenda del equipo eficientemente	gestiona
la secretaria organiza las reuniones y gestiona MASK agenda del equipo eficientemente	la
la secretaria organiza las reuniones y gestiona la MASK del equipo eficientemente	agenda
la secretaria organiza las reuniones y gestiona la agenda MASK equipo eficientemente	del
la secretaria organiza las reuniones y gestiona la agenda del MASK eficientemente	equipo
la secretaria organiza las reuniones y gestiona la agenda del equipo MASK	eficientemente
MASK empleados discuten nuevas estrategias de mercado durante la reunion semanal importante	los
los MASK discuten nuevas estrategias de mercado durante la reunion semanal importante	empleados
los empleados MASK nuevas estrategias de mercado durante la reunion semanal importante	discuten
los empleados discuten MASK estrategias de mercado durante la reunion semanal importante	nuevas
los empleados discuten nuevas MASK de mercado durante la reunion semanal importante	estrategias
los empleados discuten nuevas estrategias MASK mercado durante la reunion semanal importante	de
los empleados discuten nuevas estrategias de MASK durante la reunion semanal importante	mercado
los empleados discuten nuevas estrategias de mercado MASK la reunion semanal importante	durante
los empleados discuten nuevas estrategias de mercado durante MASK reunion semanal importante	la
los empleados discuten nuevas estrategias de mercado durante la MASK semanal importante	reunion
los empleados discuten nuevas estrategias de mercado durante la reunion MASK importante	semanal
los empleados discuten nuevas estrategias de mercado durante la reunion semanal MASK	importante
MASK colega presenta un proyecto innovador al comite directivo con mucha confianza	mi
mi MASK presenta un proyecto innovador al comite directivo con mucha confianza	colega
mi colega MASK un proyecto innovador al comite directivo con mucha confianza	presenta
mi colega presenta MASK proyecto innovador al comite directivo con mucha confianza	un
mi colega presenta un MASK innovador al comite directivo con mucha confianza	proyecto
mi colega presenta un proyecto MASK al comite directivo con mucha confianza	innovador
mi colega presenta un proyecto innovador MASK comite directivo con mucha confianza	al
mi colega presenta un proyecto innovador al MASK directivo con mucha confianza	comite
mi colega presenta un proyecto innovador al comite MASK con mucha confianza	directivo
mi colega presenta un proyecto innovador al comite directivo MASK mucha confianza	con
mi colega presenta un proyecto innovador al comite directivo con MASK confianza	mucha
mi colega presenta un proyecto innovador al comite directivo con mucha MASK	confianza
MASK impresora multifuncion no funciona correctamente desde la ultima actualizacion del sistema	la
la MASK multifuncion no funciona correctamente desde la ultima actualizacion del sistema	impresora
la impresora MASK no funciona correctamente desde la ultima actualizacion del sistema	multifuncion
la impresora multifuncion MASK funciona correctamente desde la ultima actualizacion del sistema	no
la impresora multifuncion no MASK correctamente desde la ultima actualizacion del sistema	funciona
la impresora multifuncion no funciona MASK desde la ultima actualizacion del sistema	correctamente
la impresora multifuncion no funciona correctamente MASK la ultima actualizacion del sistema	desde
la impresora multifuncion no funciona correctamente desde MASK ultima actualizacion del sistema	la
la impresora multifuncion no funciona correctamente desde la MASK actualizacion del sistema	ultima
la impresora multifuncion no funciona correctamente desde la ultima MASK del sistema	actualizacion
la impresora multifuncion no funciona correctamente desde la ultima actualizacion MASK sistema	del
la impresora multifuncion no funciona correctamente desde la ultima actualizacion del MASK	sistema
MASK terminar este informe urgente antes de la fecha limite establecida previamente	necesito
necesito MASK este informe urgente antes de la fecha limite establecida previamente	terminar
necesito terminar MASK informe urgente antes de la fecha limite establecida previamente	este
necesito terminar este MASK urgente antes de la fecha limite establecida previamente	informe
necesito terminar este informe MASK antes de la fecha limite establecida previamente	urgente
necesito terminar este informe urgente MASK de la fecha limite establecida previamente	antes
necesito terminar este informe urgente antes MASK la fecha limite establecida previamente	de
necesito terminar este informe urgente antes de MASK fecha limite establecida previamente	la
necesito terminar este informe urgente antes de la MASK limite establecida previamente	fecha
necesito terminar este informe urgente antes de la fecha MASK establecida previamente	limite
necesito terminar este informe urgente antes de la fecha limite MASK previamente	establecida
necesito terminar este informe urgente antes de la fecha limite establecida MASK	previamente
MASK ambiente de trabajo en esta empresa es colaborativo y bastante muy positivo	el
el MASK de trabajo en esta empresa es colaborativo y bastante muy positivo	ambiente
el ambiente MASK trabajo en esta empresa es colaborativo y bastante muy positivo	de
el ambiente de MASK en esta empresa es colaborativo y bastante muy positivo	trabajo
el ambiente de trabajo MASK esta empresa es colaborativo y bastante muy positivo	en
el ambiente de trabajo en MASK empresa es colaborativo y bastante muy positivo	esta
el ambiente de trabajo en esta MASK es colaborativo y bastante muy positivo	empresa
el ambiente de trabajo en esta empresa MASK colaborativo y bastante muy positivo	es
el ambiente de trabajo en esta empresa es MASK y bastante muy positivo	colaborativo
el ambiente de trabajo en esta empresa es colaborativo MASK bastante muy positivo	y
el ambiente de trabajo en esta empresa es colaborativo y MASK muy positivo	bastante
el ambiente de trabajo en esta empresa es colaborativo y bastante MASK positivo	muy
el ambiente de trabajo en esta empresa es colaborativo y bastante muy MASK	positivo
MASK una capacitacion sobre nuevas herramientas de software para mejorar nuestra productividad	recibimos
recibimos MASK capacitacion sobre nuevas herramientas de software para mejorar nuestra productividad	una
recibimos una MASK sobre nuevas herramientas de software para mejorar nuestra productividad	capacitacion
recibimos una capacitacion MASK nuevas herramientas de software para mejorar nuestra productividad	sobre
recibimos una capacitacion sobre MASK herramientas de software para mejorar nuestra productividad	nuevas
recibimos una capacitacion sobre nuevas MASK de software para mejorar nuestra productividad	herramientas
recibimos una capacitacion sobre nuevas herramientas MASK software para mejorar nuestra productividad	de
recibimos una capacitacion sobre nuevas herramientas de MASK para mejorar nuestra productividad	software
recibimos una capacitacion sobre nuevas herramientas de software MASK mejorar nuestra productividad	para
recibimos una capacitacion sobre nuevas herramientas de software para MASK nuestra productividad	mejorar
recibimos una capacitacion sobre nuevas herramientas de software para mejorar MASK productividad	nuestra
recibimos una capacitacion sobre nuevas herramientas de software para mejorar nuestra MASK	productividad
MASK departamento de recursos humanos anuncio nuevas politicas de vacaciones para el personal	el
el MASK de recursos humanos anuncio nuevas politicas de vacaciones para el personal	departamento
el departamento MASK recursos humanos anuncio nuevas politicas de vacaciones para el personal	de
el departamento de MASK humanos anuncio nuevas politicas de vacaciones para el personal	recursos
el departamento de recursos MASK anuncio nuevas politicas de vacaciones para el personal	humanos
el departamento de recursos humanos MASK nuevas politicas de vacaciones para el personal	anuncio
el departamento de recursos humanos anuncio MASK politicas de vacaciones para el personal	nuevas
el departamento de recursos humanos anuncio nuevas MASK de vacaciones para el personal	politicas
el departamento de recursos humanos anuncio nuevas politicas MASK vacaciones para el personal	de
el departamento de recursos humanos anuncio nuevas politicas de MASK para el personal	vacaciones
el departamento de recursos humanos anuncio nuevas politicas de vacaciones MASK el personal	para
el departamento de recursos humanos anuncio nuevas politicas de vacaciones para MASK personal	el
el departamento de recursos humanos anuncio nuevas politicas de vacaciones para el MASK	personal
MASK un cafe corto antes de comenzar mi jornada laboral en la oficina	tomo
tomo MASK cafe corto antes de comenzar mi jornada laboral en la oficina	un
tomo un MASK corto antes de comenzar mi jornada laboral en la oficina	cafe
tomo un cafe MASK antes de comenzar mi jornada laboral en la oficina	corto
tomo un cafe corto MASK de comenzar mi jornada laboral en la oficina	antes
tomo un cafe corto antes MASK comenzar mi jornada laboral en la oficina	de
tomo un cafe corto antes de MASK mi jornada laboral en la oficina	comenzar
tomo un cafe corto antes de comenzar MASK jornada laboral en la oficina	mi
tomo un cafe corto antes de comenzar mi MASK laboral en la oficina	jornada
tomo un cafe corto antes de comenzar mi jornada MASK en la oficina	laboral
tomo un cafe corto antes de comenzar mi jornada laboral MASK la oficina	en
tomo un cafe corto antes de comenzar mi jornada laboral en MASK oficina	la
tomo un cafe corto antes de comenzar mi jornada laboral en la MASK	oficina
MASK gusta leer novelas de ciencia ficcion durante mi tiempo libre disponible	me
me MASK leer novelas de ciencia ficcion durante mi tiempo libre disponible	gusta
me gusta MASK novelas de ciencia ficcion durante mi tiempo libre disponible	leer
me gusta leer MASK de ciencia ficcion durante mi tiempo libre disponible	novelas
me gusta leer novelas MASK ciencia ficcion durante mi tiempo libre disponible	de
me gusta leer novelas de MASK ficcion durante mi tiempo libre disponible	ciencia
me gusta leer novelas de ciencia MASK durante mi tiempo libre disponible	ficcion
me gusta leer novelas de ciencia ficcion MASK mi tiempo libre disponible	durante
me gusta leer novelas de ciencia ficcion durante MASK tiempo libre disponible	mi
me gusta leer novelas de ciencia ficcion durante mi MASK libre disponible	tiempo
me gusta leer novelas de ciencia ficcion durante mi tiempo MASK disponible	libre
me gusta leer novelas de ciencia ficcion durante mi tiempo libre MASK	disponible
MASK al cine para ver el ultimo estreno de accion este fin semana	vamos
vamos MASK cine para ver el ultimo estreno de accion este fin semana	al
vamos al MASK para ver el ultimo estreno de accion este fin semana	cine
vamos al cine MASK ver el ultimo estreno de accion este fin semana	para
vamos al cine para MASK el ultimo estreno de accion este fin semana	ver
vamos al cine para ver MASK ultimo estreno de accion este fin semana	el
vamos al cine para ver el MASK estreno de accion este fin semana	ultimo
vamos al cine para ver el ultimo MASK de accion este fin semana	estreno
vamos al cine para ver el ultimo estreno MASK accion este fin semana	de
vamos al cine para ver el ultimo estreno de MASK este fin semana	accion
vamos al cine para ver el ultimo estreno de accion MASK fin semana	este
vamos al cine para ver el ultimo estreno de accion este MASK semana	fin
vamos al cine para ver el ultimo estreno de accion este fin MASK	semana
MASK amigo colecciona sellos antiguos de diferentes paises del vasto mundo entero	mi
mi MASK colecciona sellos antiguos de diferentes paises del vasto mundo entero	amigo
mi amigo MASK sellos antiguos de diferentes paises del vasto mundo entero	colecciona
mi amigo colecciona MASK antiguos de diferentes paises del vasto mundo entero	sellos
mi amigo colecciona sellos MASK de diferentes paises del vasto mundo entero	antiguos
mi amigo colecciona sellos antiguos MASK diferentes paises del vasto mundo entero	de
mi amigo colecciona sellos antiguos de MASK paises del vasto mundo entero	diferentes
mi amigo colecciona sellos antiguos de diferentes MASK del vasto mundo entero	paises
mi amigo colecciona sellos antiguos de diferentes paises MASK vasto mundo entero	del
mi amigo colecciona sellos antiguos de diferentes paises del MASK mundo entero	vasto
mi amigo colecciona sellos antiguos de diferentes paises del vasto MASK entero	mundo
mi amigo colecciona sellos antiguos de diferentes paises del vasto mundo MASK	entero
MASK yoga tres veces por semana para relajarme y mantenerme en forma	practico
practico MASK tres veces por semana para relajarme y mantenerme en forma	yoga
practico yoga MASK veces por semana para relajarme y mantenerme en forma	tres
practico yoga tres MASK por semana para relajarme y mantenerme en forma	veces
practico yoga tres veces MASK semana para relajarme y mantenerme en forma	por
practico yoga tres veces por MASK para relajarme y mantenerme en forma	semana
practico yoga tres veces por semana MASK relajarme y mantenerme en forma	para
practico yoga tres veces por semana para MASK y mantenerme en forma	relajarme
practico yoga tres veces por semana para relajarme MASK mantenerme en forma	y
practico yoga tres veces por semana para relajarme y MASK en forma	mantenerme
practico yoga tres veces por semana para relajarme y mantenerme MASK forma	en
practico yoga tres veces por semana para relajarme y mantenerme en MASK	forma
MASK musica clasica me ayuda a concentrarme cuando estoy estudiando o trabajando	escuchar
escuchar MASK clasica me ayuda a concentrarme cuando estoy estudiando o trabajando	musica
escuchar musica MASK me ayuda a concentrarme cuando estoy estudiando o trabajando	clasica
escuchar musica clasica MASK ayuda a concentrarme cuando estoy estudiando o trabajando	me
escuchar musica clasica me MASK a concentrarme cuando estoy estudiando o trabajando	ayuda
escuchar musica clasica me ayuda MASK concentrarme cuando estoy estudiando o trabajando	a
escuchar musica clasica me ayuda a MASK cuando estoy estudiando o trabajando	concentrarme
escuchar musica clasica me ayuda a concentrarme MASK estoy estudiando o trabajando	cuando
escuchar musica clasica me ayuda a concentrarme cuando MASK estudiando o trabajando	estoy
escuchar musica clasica me ayuda a concentrarme cuando estoy MASK o trabajando	estudiando
escuchar musica clasica me ayuda a concentrarme cuando estoy estudiando MASK trabajando	o
escuchar musica clasica me ayuda a concentrarme cuando estoy estudiando o MASK	trabajando
MASK paisajes al oleo es mi pasion mas grande desde la infancia	pintar
pintar MASK al oleo es mi pasion mas grande desde la infancia	paisajes
pintar paisajes MASK oleo es mi pasion mas grande desde la infancia	al
pintar paisajes al MASK es mi pasion mas grande desde la infancia	oleo
pintar paisajes al oleo MASK mi pasion mas grande desde la infancia	es
pintar paisajes al oleo es MASK pasion mas grande desde la infancia	mi
pintar paisajes al oleo es mi MASK mas grande desde la infancia	pasion
pintar paisajes al oleo es mi pasion MASK grande desde la infancia	mas
pintar paisajes al oleo es mi pasion mas MASK desde la infancia	grande
pintar paisajes al oleo es mi pasion mas grande MASK la infancia	desde
pintar paisajes al oleo es mi pasion mas grande desde MASK infancia	la
pintar paisajes al oleo es mi pasion mas grande desde la MASK	infancia
MASK un partido de futbol con amigos en el campo cercano ayer	jugamos
jugamos MASK partido de futbol con amigos en el campo cercano ayer	un
jugamos un MASK de futbol con amigos en el campo cercano ayer	partido
jugamos un partido MASK futbol con amigos en el campo cercano ayer	de
jugamos un partido de MASK con amigos en el campo cercano ayer	futbol
jugamos un partido de futbol MASK amigos en el campo cercano ayer	con
jugamos un partido de futbol con MASK en el campo cercano ayer	amigos
jugamos un partido de futbol con amigos MASK el campo cercano ayer	en
jugamos un partido de futbol con amigos en MASK campo cercano ayer	el
jugamos un partido de futbol con amigos en el MASK cercano ayer	campo
jugamos un partido de futbol con amigos en el campo MASK ayer	cercano
jugamos un partido de futbol con amigos en el campo cercano MASK	ayer
MASK club de lectura se reune una vez al mes para discutir libros	el
el MASK de lectura se reune una vez al mes para discutir libros	club
el club MASK lectura se reune una vez al mes para discutir libros	de
el club de MASK se reune una vez al mes para discutir libros	lectura
el club de lectura MASK reune una vez al mes para discutir libros	se
el club de lectura se MASK una vez al mes para discutir libros	reune
el club de lectura se reune MASK vez al mes para discutir libros	una
el club de lectura se reune una MASK al mes para discutir libros	vez
el club de lectura se reune una vez MASK mes para discutir libros	al
el club de lectura se reune una vez al MASK para discutir libros	mes
el club de lectura se reune una vez al mes MASK discutir libros	para
el club de lectura se reune una vez al mes para MASK libros	discutir
el club de lectura se reune una vez al mes para discutir MASK	libros
MASK mucho pasear en bicicleta por el parque durante las tardes soleadas	disfruto
disfruto MASK pasear en bicicleta por el parque durante las tardes soleadas	mucho
disfruto mucho MASK en bicicleta por el parque durante las tardes soleadas	pasear
disfruto mucho pasear MASK bicicleta por el parque durante las tardes soleadas	en
disfruto mucho pasear en MASK por el parque durante las tardes soleadas	bicicleta
disfruto mucho pasear en bicicleta MASK el parque durante las tardes soleadas	por
disfruto mucho pasear en bicicleta por MASK parque durante las tardes soleadas	el
disfruto mucho pasear en bicicleta por el MASK durante las tardes soleadas	parque
disfruto mucho pasear en bicicleta por el parque MASK las tardes soleadas	durante
disfruto mucho pasear en bicicleta por el parque durante MASK tardes soleadas	las
disfruto mucho pasear en bicicleta por el parque durante las MASK soleadas	tardes
disfruto mucho pasear en bicicleta por el parque durante las tardes MASK	soleadas
MASK a tocar la guitarra es un desafio divertido y muy gratificante	aprender
aprender MASK tocar la guitarra es un desafio divertido y muy gratificante	a
aprender a MASK la guitarra es un desafio divertido y muy gratificante	tocar
aprender a tocar MASK guitarra es un desafio divertido y muy gratificante	la
aprender a tocar la MASK es un desafio divertido y muy gratificante	guitarra
aprender a tocar la guitarra MASK un desafio divertido y muy gratificante	es
aprender a tocar la guitarra es MASK desafio divertido y muy gratificante	un
aprender a tocar la guitarra es un MASK divertido y muy gratificante	desafio
aprender a tocar la guitarra es un desafio MASK y muy gratificante	divertido
aprender a tocar la guitarra es un desafio divertido MASK muy gratificante	y
aprender a tocar la guitarra es un desafio divertido y MASK gratificante	muy
aprender a tocar la guitarra es un desafio divertido y muy MASK	gratificante
MASK flores silvestres crecen abundantemente en la pradera durante la corta primavera	las
las MASK silvestres crecen abundantemente en la pradera durante la corta primavera	flores
las flores MASK crecen abundantemente en la pradera durante la corta primavera	silvestres
las flores silvestres MASK abundantemente en la pradera durante la corta primavera	crecen
las flores silvestres crecen MASK en la pradera durante la corta primavera	abundantemente
las flores silvestres crecen abundantemente MASK la pradera durante la corta primavera	en
las flores silvestres crecen abundantemente en MASK pradera durante la corta primavera	la
las flores silvestres crecen abundantemente en la MASK durante la corta primavera	pradera
las flores silvestres crecen abundantemente en la pradera MASK la corta primavera	durante
las flores silvestres crecen abundantemente en la pradera durante MASK corta primavera	la
las flores silvestres crecen abundantemente en la pradera durante la MASK primavera	corta
las flores silvestres crecen abundantemente en la pradera durante la corta MASK	primavera
MASK sol brilla intensamente sobre las montanas nevadas creando un paisaje espectacular	el
el MASK brilla intensamente sobre las montanas nevadas creando un paisaje espectacular	sol
el sol MASK intensamente sobre las montanas nevadas creando un paisaje espectacular	brilla
el sol brilla MASK sobre las montanas nevadas creando un paisaje espectacular	intensamente
el sol brilla intensamente MASK las montanas nevadas creando un paisaje espectacular	sobre
el sol brilla intensamente sobre MASK montanas nevadas creando un paisaje espectacular	las
el sol brilla intensamente sobre las MASK nevadas creando un paisaje espectacular	montanas
el sol brilla intensamente sobre las montanas MASK creando un paisaje espectacular	nevadas
el sol brilla intensamente sobre las montanas nevadas MASK un paisaje espectacular	creando
el sol brilla intensamente sobre las montanas nevadas creando MASK paisaje espectacular	un
el sol brilla intensamente sobre las montanas nevadas creando un MASK espectacular	paisaje
el sol brilla intensamente sobre las montanas nevadas creando un paisaje MASK	espectacular
MASK pajaros cantan alegremente en los arboles altos al amanecer cada dia	los
los MASK cantan alegremente en los arboles altos al amanecer cada dia	pajaros
los pajaros MASK alegremente en los arboles altos al amanecer cada dia	cantan
los pajaros cantan MASK en los arboles altos al amanecer cada dia	alegremente
los pajaros cantan alegremente MASK los arboles altos al amanecer cada dia	en
los pajaros cantan alegremente en MASK arboles altos al amanecer cada dia	los
los pajaros cantan alegremente en los MASK altos al amanecer cada dia	arboles
los pajaros cantan alegremente en los arboles MASK al amanecer cada dia	altos
los pajaros cantan alegremente en los arboles altos MASK amanecer cada dia	al
los pajaros cantan alegremente en los arboles altos al MASK cada dia	amanecer
los pajaros cantan alegremente en los arboles altos al amanecer MASK dia	cada
los pajaros cantan alegremente en los arboles altos al amanecer cada MASK	dia
MASK tormenta electrica fuerte se aproxima rapidamente desde el oscuro horizonte oeste	una
una MASK electrica fuerte se aproxima rapidamente desde el oscuro horizonte oeste	tormenta
una tormenta MASK fuerte se aproxima rapidamente desde el oscuro horizonte oeste	electrica
una tormenta electrica MASK se aproxima rapidamente desde el oscuro horizonte oeste	fuerte
una tormenta electrica fuerte MASK aproxima rapidamente desde el oscuro horizonte oeste	se
una tormenta electrica fuerte se MASK rapidamente desde el oscuro horizonte oeste	aproxima
una tormenta electrica fuerte se aproxima MASK desde el oscuro horizonte oeste	rapidamente
una tormenta electrica fuerte se aproxima rapidamente MASK el oscuro horizonte oeste	desde
una tormenta electrica fuerte se aproxima rapidamente desde MASK oscuro horizonte oeste	el
una tormenta electrica fuerte se aproxima rapidamente desde el MASK horizonte oeste	oscuro
una tormenta electrica fuerte se aproxima rapidamente desde el oscuro MASK oeste	horizonte
una tormenta electrica fuerte se aproxima rapidamente desde el oscuro horizonte MASK	oeste
MASK rio caudaloso atraviesa el valle fertil llevando vida a toda la region	el
el MASK caudaloso atraviesa el valle fertil llevando vida a toda la region	rio
el rio MASK atraviesa el valle fertil llevando vida a toda la region	caudaloso
el rio caudaloso MASK el valle fertil llevando vida a toda la region	atraviesa
el rio caudaloso atraviesa MASK valle fertil llevando vida a toda la region	el
el rio caudaloso atraviesa el MASK fertil llevando vida a toda la region	valle
el rio caudaloso atraviesa el valle MASK llevando vida a toda la region	fertil
el rio caudaloso atraviesa el valle fertil MASK vida a toda la region	llevando
el rio caudaloso atraviesa el valle fertil llevando MASK a toda la region	vida
el rio caudaloso atraviesa el valle fertil llevando vida MASK toda la region	a
el rio caudaloso atraviesa el valle fertil llevando vida a MASK la region	toda
el rio caudaloso atraviesa el valle fertil llevando vida a toda MASK region	la
el rio caudaloso atraviesa el valle fertil llevando vida a toda la MASK	region
MASK hojas de los arboles cambian de color en otono antes de caer	las
las MASK de los arboles cambian de color en otono antes de caer	hojas
las hojas MASK los arboles cambian de color en otono antes de caer	de
las hojas de MASK arboles cambian de color en otono antes de caer	los
las hojas de los MASK cambian de color en otono antes de caer	arboles
las hojas de los arboles MASK de color en otono antes de caer	cambian
las hojas de los arboles cambian MASK color en otono antes de caer	de
las hojas de los arboles cambian de MASK en otono antes de caer	color
las hojas de los arboles cambian de color MASK otono antes de caer	en
las hojas de los arboles cambian de color en MASK antes de caer	otono
las hojas de los arboles cambian de color en otono MASK de caer	antes
las hojas de los arboles cambian de color en otono antes MASK caer	de
las hojas de los arboles cambian de color en otono antes de MASK	caer
MASK lluvia fina cae suavemente sobre el tejado de la vieja cabana	la
la MASK fina cae suavemente sobre el tejado de la vieja cabana	lluvia
la lluvia MASK cae suavemente sobre el tejado de la vieja cabana	fina
la lluvia fina MASK suavemente sobre el tejado de la vieja cabana	cae
la lluvia fina cae MASK sobre el tejado de la vieja cabana	suavemente
la lluvia fina cae suavemente MASK el tejado de la vieja cabana	sobre
la lluvia fina cae suavemente sobre MASK tejado de la vieja cabana	el
la lluvia fina cae suavemente sobre el MASK de la vieja cabana	tejado
la lluvia fina cae suavemente sobre el tejado MASK la vieja cabana	de
la lluvia fina cae suavemente sobre el tejado de MASK vieja cabana	la
la lluvia fina cae suavemente sobre el tejado de la MASK cabana	vieja
la lluvia fina cae suavemente sobre el tejado de la vieja MASK	cabana
MASK las estrellas brillantes en el cielo nocturno despejado lejos de luces	observamos
observamos MASK estrellas brillantes en el cielo nocturno despejado lejos de luces	las
observamos las MASK brillantes en el cielo nocturno despejado lejos de luces	estrellas
observamos las estrellas MASK en el cielo nocturno despejado lejos de luces	brillantes
observamos las estrellas brillantes MASK el cielo nocturno despejado lejos de luces	en
observamos las estrellas brillantes en MASK cielo nocturno despejado lejos de luces	el
observamos las estrellas brillantes en el MASK nocturno despejado lejos de luces	cielo
observamos las estrellas brillantes en el cielo MASK despejado lejos de luces	nocturno
observamos las estrellas brillantes en el cielo nocturno MASK lejos de luces	despejado
observamos las estrellas brillantes en el cielo nocturno despejado MASK de luces	lejos
observamos las estrellas brillantes en el cielo nocturno despejado lejos MASK luces	de
observamos las estrellas brillantes en el cielo nocturno despejado lejos de MASK	luces
MASK viento sopla con fuerza levantando polvo y pequenas ramas del suelo seco	el
el MASK sopla con fuerza levantando polvo y pequenas ramas del suelo seco	viento
el viento MASK con fuerza levantando polvo y pequenas ramas del suelo seco	sopla
el viento sopla MASK fuerza levantando polvo y pequenas ramas del suelo seco	con
el viento sopla con MASK levantando polvo y pequenas ramas del suelo seco	fuerza
el viento sopla con fuerza MASK polvo y pequenas ramas del suelo seco	levantando
el viento sopla con fuerza levantando MASK y pequenas ramas del suelo seco	polvo
el viento sopla con fuerza levantando polvo MASK pequenas ramas del suelo seco	y
el viento sopla con fuerza levantando polvo y MASK ramas del suelo seco	pequenas
el viento sopla con fuerza levantando polvo y pequenas MASK del suelo seco	ramas
el viento sopla con fuerza levantando polvo y pequenas ramas MASK suelo seco	del
el viento sopla con fuerza levantando polvo y pequenas ramas del MASK seco	suelo
el viento sopla con fuerza levantando polvo y pequenas ramas del suelo MASK	seco
MASK niebla densa cubre la ciudad dificultando la vision de los conductores	la
la MASK densa cubre la ciudad dificultando la vision de los conductores	niebla
la niebla MASK cubre la ciudad dificultando la vision de los conductores	densa
la niebla densa MASK la ciudad dificultando la vision de los conductores	cubre
la niebla densa cubre MASK ciudad dificultando la vision de los conductores	la
la niebla densa cubre la MASK dificultando la vision de los conductores	ciudad
la niebla densa cubre la ciudad MASK la vision de los conductores	dificultando
la niebla densa cubre la ciudad dificultando MASK vision de los conductores	la
la niebla densa cubre la ciudad dificultando la MASK de los conductores	vision
la niebla densa cubre la ciudad dificultando la vision MASK los conductores	de
la niebla densa cubre la ciudad dificultando la vision de MASK conductores	los
la niebla densa cubre la ciudad dificultando la vision de los MASK	conductores
MASK biblioteca publica ofrece una gran variedad de libros para todos los gustos	la
la MASK publica ofrece una gran variedad de libros para todos los gustos	biblioteca
la biblioteca MASK ofrece una gran variedad de libros para todos los gustos	publica
la biblioteca publica MASK una gran variedad de libros para todos los gustos	ofrece
la biblioteca publica ofrece MASK gran variedad de libros para todos los gustos	una
la biblioteca publica ofrece una MASK variedad de libros para todos los gustos	gran
la biblioteca publica ofrece una gran MASK de libros para todos los gustos	variedad
la biblioteca publica ofrece una gran variedad MASK libros para todos los gustos	de
la biblioteca publica ofrece una gran variedad de MASK para todos los gustos	libros
la biblioteca publica ofrece una gran variedad de libros MASK todos los gustos	para
la biblioteca publica ofrece una gran variedad de libros para MASK los gustos	todos
la biblioteca publica ofrece una gran variedad de libros para todos MASK gustos	los
la biblioteca publica ofrece una gran variedad de libros para todos los MASK	gustos
MASK ayuntamiento organiza eventos culturales gratuitos para los ciudadanos durante el verano	el
el MASK organiza eventos culturales gratuitos para los ciudadanos durante el verano	ayuntamiento
el ayuntamiento MASK eventos culturales gratuitos para los ciudadanos durante el verano	organiza
el ayuntamiento organiza MASK culturales gratuitos para los ciudadanos durante el verano	eventos
el ayuntamiento organiza eventos MASK gratuitos para los ciudadanos durante el verano	culturales
el ayuntamiento organiza eventos culturales MASK para los ciudadanos durante el verano	gratuitos
el ayuntamiento organiza eventos culturales gratuitos MASK los ciudadanos durante el verano	para
el ayuntamiento organiza eventos culturales gratuitos para MASK ciudadanos durante el verano	los
el ayuntamiento organiza eventos culturales gratuitos para los MASK durante el verano	ciudadanos
el ayuntamiento organiza eventos culturales gratuitos para los ciudadanos MASK el verano	durante
el ayuntamiento organiza eventos culturales gratuitos para los ciudadanos durante MASK verano	el
el ayuntamiento organiza eventos culturales gratuitos para los ciudadanos durante el MASK	verano
MASK un nuevo centro comercial con muchas tiendas modernas en las afueras	hay
hay MASK nuevo centro comercial con muchas tiendas modernas en las afueras	un
hay un MASK centro comercial con muchas tiendas modernas en las afueras	nuevo
hay un nuevo MASK comercial con muchas tiendas modernas en las afueras	centro
hay un nuevo centro MASK con muchas tiendas modernas en las afueras	comercial
hay un nuevo centro comercial MASK muchas tiendas modernas en las afueras	con
hay un nuevo centro comercial con MASK tiendas modernas en las afueras	muchas
hay un nuevo centro comercial con muchas MASK modernas en las afueras	tiendas
hay un nuevo centro comercial con muchas tiendas MASK en las afueras	modernas
hay un nuevo centro comercial con muchas tiendas modernas MASK las afueras	en
hay un nuevo centro comercial con muchas tiendas modernas en MASK afueras	las
hay un nuevo centro comercial con muchas tiendas modernas en las MASK	afueras
MASK bomberos acudieron rapidamente para apagar el incendio en el edificio antiguo	los
los MASK acudieron rapidamente para apagar el incendio en el edificio antiguo	bomberos
los bomberos MASK rapidamente para apagar el incendio en el edificio antiguo	acudieron
los bomberos acudieron MASK para apagar el incendio en el edificio antiguo	rapidamente
los bomberos acudieron rapidamente MASK apagar el incendio en el edificio antiguo	para
los bomberos acudieron rapidamente para MASK el incendio en el edificio antiguo	apagar
los bomberos acudieron rapidamente para apagar MASK incendio en el edificio antiguo	el
los bomberos acudieron rapidamente para apagar el MASK en el edificio antiguo	incendio
los bomberos acudieron rapidamente para apagar el incendio MASK el edificio antiguo	en
los bomberos acudieron rapidamente para apagar el incendio en MASK edificio antiguo	el
los bomberos acudieron rapidamente para apagar el incendio en el MASK antiguo	edificio
los bomberos acudieron rapidamente para apagar el incendio en el edificio MASK	antiguo
MASK hospital general cuenta con excelentes medicos y equipamiento de ultima generacion	el
el MASK general cuenta con excelentes medicos y equipamiento de ultima generacion	hospital
el hospital MASK cuenta con excelentes medicos y equipamiento de ultima generacion	general
el hospital general MASK con excelentes medicos y equipamiento de ultima generacion	cuenta
el hospital general cuenta MASK excelentes medicos y equipamiento de ultima generacion	con
el hospital general cuenta con MASK medicos y equipamiento de ultima generacion	excelentes
el hospital general cuenta con excelentes MASK y equipamiento de ultima generacion	medicos
el hospital general cuenta con excelentes medicos MASK equipamiento de ultima generacion	y
el hospital general cuenta con excelentes medicos y MASK de ultima generacion	equipamiento
el hospital general cuenta con excelentes medicos y equipamiento MASK ultima generacion	de
el hospital general cuenta con excelentes medicos y equipamiento de MASK generacion	ultima
el hospital general cuenta con excelentes medicos y equipamiento de ultima MASK	generacion
MASK policia local patrulla las calles para garantizar la seguridad de los vecinos	la
la MASK local patrulla las calles para garantizar la seguridad de los vecinos	policia
la policia MASK patrulla las calles para garantizar la seguridad de los vecinos	local
la policia local MASK las calles para garantizar la seguridad de los vecinos	patrulla
la policia local patrulla MASK calles para garantizar la seguridad de los vecinos	las
la policia local patrulla las MASK para garantizar la seguridad de los vecinos	calles
la policia local patrulla las calles MASK garantizar la seguridad de los vecinos	para
la policia local patrulla las calles para MASK la seguridad de los vecinos	garantizar
la policia local patrulla las calles para garantizar MASK seguridad de los vecinos	la
la policia local patrulla las calles para garantizar la MASK de los vecinos	seguridad
la policia local patrulla las calles para garantizar la seguridad MASK los vecinos	de
la policia local patrulla las calles para garantizar la seguridad de MASK vecinos	los
la policia local patrulla las calles para garantizar la seguridad de los MASK	vecinos
MASK parque central tiene un lago artificial donde la gente pasea en bote	el
el MASK central tiene un lago artificial donde la gente pasea en bote	parque
el parque MASK tiene un lago artificial donde la gente pasea en bote	central
el parque central MASK un lago artificial donde la gente pasea en bote	tiene
el parque central tiene MASK lago artificial donde la gente pasea en bote	un
el parque central tiene un MASK artificial donde la gente pasea en bote	lago
el parque central tiene un lago MASK donde la gente pasea en bote	artificial
el parque central tiene un lago artificial MASK la gente pasea en bote	donde
el parque central tiene un lago artificial donde MASK gente pasea en bote	la
el parque central tiene un lago artificial donde la MASK pasea en bote	gente
el parque central tiene un lago artificial donde la gente MASK en bote	pasea
el parque central tiene un lago artificial donde la gente pasea MASK bote	en
el parque central tiene un lago artificial donde la gente pasea en MASK	bote
MASK calles del centro historico son estrechas y estan llenas de tiendas	las
las MASK del centro historico son estrechas y estan llenas de tiendas	calles
las calles MASK centro historico son estrechas y estan llenas de tiendas	del
las calles del MASK historico son estrechas y estan llenas de tiendas	centro
las calles del centro MASK son estrechas y estan llenas de tiendas	historico
las calles del centro historico MASK estrechas y estan llenas de tiendas	son
las calles del centro historico son MASK y estan llenas de tiendas	estrechas
las calles del centro historico son estrechas MASK estan llenas de tiendas	y
las calles del centro historico son estrechas y MASK llenas de tiendas	estan
las calles del centro historico son estrechas y estan MASK de tiendas	llenas
las calles del centro historico son estrechas y estan llenas MASK tiendas	de
las calles del centro historico son estrechas y estan llenas de MASK	tiendas
MASK oficina de correos cierra a las cinco de la tarde normalmente	la
la MASK de correos cierra a las cinco de la tarde normalmente	oficina
la oficina MASK correos cierra a las cinco de la tarde normalmente	de
la oficina de MASK cierra a las cinco de la tarde normalmente	correos
la oficina de correos MASK a las cinco de la tarde normalmente	cierra
la oficina de correos cierra MASK las cinco de la tarde normalmente	a
la oficina de correos cierra a MASK cinco de la tarde normalmente	las
la oficina de correos cierra a las MASK de la tarde normalmente	cinco
la oficina de correos cierra a las cinco MASK la tarde normalmente	de
la oficina de correos cierra a las cinco de MASK tarde normalmente	la
la oficina de correos cierra a las cinco de la MASK normalmente	tarde
la oficina de correos cierra a las cinco de la tarde MASK	normalmente
MASK un nuevo polideportivo con piscina climatizada cerca de mi casa pronto	construiran
construiran MASK nuevo polideportivo con piscina climatizada cerca de mi casa pronto	un
construiran un MASK polideportivo con piscina climatizada cerca de mi casa pronto	nuevo
construiran un nuevo MASK con piscina climatizada cerca de mi casa pronto	polideportivo
construiran un nuevo polideportivo MASK piscina climatizada cerca de mi casa pronto	con
construiran un nuevo polideportivo con MASK climatizada cerca de mi casa pronto	piscina
construiran un nuevo polideportivo con piscina MASK cerca de mi casa pronto	climatizada
construiran un nuevo polideportivo con piscina climatizada MASK de mi casa pronto	cerca
construiran un nuevo polideportivo con piscina climatizada cerca MASK mi casa pronto	de
construiran un nuevo polideportivo con piscina climatizada cerca de MASK casa pronto	mi
construiran un nuevo polideportivo con piscina climatizada cerca de mi MASK pronto	casa
construiran un nuevo polideportivo con piscina climatizada cerca de mi casa MASK	pronto
MASK autobus numero cinco pasa cada quince minutos por esta parada exactamente	el
el MASK numero cinco pasa cada quince minutos por esta parada exactamente	autobus
el autobus MASK cinco pasa cada quince minutos por esta parada exactamente	numero
el autobus numero MASK pasa cada quince minutos por esta parada exactamente	cinco
el autobus numero cinco MASK cada quince minutos por esta parada exactamente	pasa
el autobus numero cinco pasa MASK quince minutos por esta parada exactamente	cada
el autobus numero cinco pasa cada MASK minutos por esta parada exactamente	quince
el autobus numero cinco pasa cada quince MASK por esta parada exactamente	minutos
el autobus numero cinco pasa cada quince minutos MASK esta parada exactamente	por
el autobus numero cinco pasa cada quince minutos por MASK parada exactamente	esta
el autobus numero cinco pasa cada quince minutos por esta MASK exactamente	parada
el autobus numero cinco pasa cada quince minutos por esta parada MASK	exactamente
MASK viajar en tren para distancias largas porque es mas comodo y rapido	prefiero
prefiero MASK en tren para distancias largas porque es mas comodo y rapido	viajar
prefiero viajar MASK tren para distancias largas porque es mas comodo y rapido	en
prefiero viajar en MASK para distancias largas porque es mas comodo y rapido	tren
prefiero viajar en tren MASK distancias largas porque es mas comodo y rapido	para
prefiero viajar en tren para MASK largas porque es mas comodo y rapido	distancias
prefiero viajar en tren para distancias MASK porque es mas comodo y rapido	largas
prefiero viajar en tren para distancias largas MASK es mas comodo y rapido	porque
prefiero viajar en tren para distancias largas porque MASK mas comodo y rapido	es
prefiero viajar en tren para distancias largas porque es MASK comodo y rapido	mas
prefiero viajar en tren para distancias largas porque es mas MASK y rapido	comodo
prefiero viajar en tren para distancias largas porque es mas comodo MASK rapido	y
prefiero viajar en tren para distancias largas porque es mas comodo y MASK	rapido
MASK trafico en la autopista principal esta congestionado debido a un accidente	el
el MASK en la autopista principal esta congestionado debido a un accidente	trafico
el trafico MASK la autopista principal esta congestionado debido a un accidente	en
el trafico en MASK autopista principal esta congestionado debido a un accidente	la
el trafico en la MASK principal esta congestionado debido a un accidente	autopista
el trafico en la autopista MASK esta congestionado debido a un accidente	principal
el trafico en la autopista principal MASK congestionado debido a un accidente	esta
el trafico en la autopista principal esta MASK debido a un accidente	congestionado
el trafico en la autopista principal esta congestionado MASK a un accidente	debido
el trafico en la autopista principal esta congestionado debido MASK un accidente	a
el trafico en la autopista principal esta congestionado debido a MASK accidente	un
el trafico en la autopista principal esta congestionado debido a un MASK	accidente
MASK ciclistas utilizan el carril bici para moverse por toda la ciudad	muchos
muchos MASK utilizan el carril bici para moverse por toda la ciudad	ciclistas
muchos ciclistas MASK el carril bici para moverse por toda la ciudad	utilizan
muchos ciclistas utilizan MASK carril bici para moverse por toda la ciudad	el
muchos ciclistas utilizan el MASK bici para moverse por toda la ciudad	carril
muchos ciclistas utilizan el carril MASK para moverse por toda la ciudad	bici
muchos ciclistas utilizan el carril bici MASK moverse por toda la ciudad	para
muchos ciclistas utilizan el carril bici para MASK por toda la ciudad	moverse
muchos ciclistas utilizan el carril bici para moverse MASK toda la ciudad	por
muchos ciclistas utilizan el carril bici para moverse por MASK la ciudad	toda
muchos ciclistas utilizan el carril bici para moverse por toda MASK ciudad	la
muchos ciclistas utilizan el carril bici para moverse por toda la MASK	ciudad
MASK aeropuerto internacional tiene vuelos directos a muchas capitales del gran mundo	el
el MASK internacional tiene vuelos directos a muchas capitales del gran mundo	aeropuerto
el aeropuerto MASK tiene vuelos directos a muchas capitales del gran mundo	internacional
el aeropuerto internacional MASK vuelos directos a muchas capitales del gran mundo	tiene
el aeropuerto internacional tiene MASK directos a muchas capitales del gran mundo	vuelos
el aeropuerto internacional tiene vuelos MASK a muchas capitales del gran mundo	directos
el aeropuerto internacional tiene vuelos directos MASK muchas capitales del gran mundo	a
el aeropuerto internacional tiene vuelos directos a MASK capitales del gran mundo	muchas
el aeropuerto internacional tiene vuelos directos a muchas MASK del gran mundo	capitales
el aeropuerto internacional tiene vuelos directos a muchas capitales MASK gran mundo	del
el aeropuerto internacional tiene vuelos directos a muchas capitales del MASK mundo	gran
el aeropuerto internacional tiene vuelos directos a muchas capitales del gran MASK	mundo
MASK estacion de metro mas cercana esta a solo dos calles de aqui	la
la MASK de metro mas cercana esta a solo dos calles de aqui	estacion
la estacion MASK metro mas cercana esta a solo dos calles de aqui	de
la estacion de MASK mas cercana esta a solo dos calles de aqui	metro
la estacion de metro MASK cercana esta a solo dos calles de aqui	mas
la estacion de metro mas MASK esta a solo dos calles de aqui	cercana
la estacion de metro mas cercana MASK a solo dos calles de aqui	esta
la estacion de metro mas cercana esta MASK solo dos calles de aqui	a
la estacion de metro mas cercana esta a MASK dos calles de aqui	solo
la estacion de metro mas cercana esta a solo MASK calles de aqui	dos
la estacion de metro mas cercana esta a solo dos MASK de aqui	calles
la estacion de metro mas cercana esta a solo dos calles MASK aqui	de
la estacion de metro mas cercana esta a solo dos calles de MASK	aqui
MASK taxi nos dejo justo en la puerta del hotel sin ningun problema	el
el MASK nos dejo justo en la puerta del hotel sin ningun problema	taxi
el taxi MASK dejo justo en la puerta del hotel sin ningun problema	nos
el taxi nos MASK justo en la puerta del hotel sin ningun problema	dejo
el taxi nos dejo MASK en la puerta del hotel sin ningun problema	justo
el taxi nos dejo justo MASK la puerta del hotel sin ningun problema	en
el taxi nos dejo justo en MASK puerta del hotel sin ningun problema	la
el taxi nos dejo justo en la MASK del hotel sin ningun problema	puerta
el taxi nos dejo justo en la puerta MASK hotel sin ningun problema	del
el taxi nos dejo justo en la puerta del MASK sin ningun problema	hotel
el taxi nos dejo justo en la puerta del hotel MASK ningun problema	sin
el taxi nos dejo justo en la puerta del hotel sin MASK problema	ningun
el taxi nos dejo justo en la puerta del hotel sin ningun MASK	problema
MASK es una forma saludable y economica de transporte para distancias cortas	caminar
caminar MASK una forma saludable y economica de transporte para distancias cortas	es
caminar es MASK forma saludable y economica de transporte para distancias cortas	una
caminar es una MASK saludable y economica de transporte para distancias cortas	forma
caminar es una forma MASK y economica de transporte para distancias cortas	saludable
caminar es una forma saludable MASK economica de transporte para distancias cortas	y
caminar es una forma saludable y MASK de transporte para distancias cortas	economica
caminar es una forma saludable y economica MASK transporte para distancias cortas	de
caminar es una forma saludable y economica de MASK para distancias cortas	transporte
caminar es una forma saludable y economica de transporte MASK distancias cortas	para
caminar es una forma saludable y economica de transporte para MASK cortas	distancias
caminar es una forma saludable y economica de transporte para distancias MASK	cortas
MASK ferry cruza la bahia varias veces al dia conectando ambas orillas	el
el MASK cruza la bahia varias veces al dia conectando ambas orillas	ferry
el ferry MASK la bahia varias veces al dia conectando ambas orillas	cruza
el ferry cruza MASK bahia varias veces al dia conectando ambas orillas	la
el ferry cruza la MASK varias veces al dia conectando ambas orillas	bahia
el ferry cruza la bahia MASK veces al dia conectando ambas orillas	varias
el ferry cruza la bahia varias MASK al dia conectando ambas orillas	veces
el ferry cruza la bahia varias veces MASK dia conectando ambas orillas	al
el ferry cruza la bahia varias veces al MASK conectando ambas orillas	dia
el ferry cruza la bahia varias veces al dia MASK ambas orillas	conectando
el ferry cruza la bahia varias veces al dia conectando MASK orillas	ambas
el ferry cruza la bahia varias veces al dia conectando ambas MASK	orillas
MASK tranvia moderno recorre el centro historico ofreciendo vistas unicas de edificios	el
el MASK moderno recorre el centro historico ofreciendo vistas unicas de edificios	tranvia
el tranvia MASK recorre el centro historico ofreciendo vistas unicas de edificios	moderno
el tranvia moderno MASK el centro historico ofreciendo vistas unicas de edificios	recorre
el tranvia moderno recorre MASK centro historico ofreciendo vistas unicas de edificios	el
el tranvia moderno recorre el MASK historico ofreciendo vistas unicas de edificios	centro
el tranvia moderno recorre el centro MASK ofreciendo vistas unicas de edificios	historico
el tranvia moderno recorre el centro historico MASK vistas unicas de edificios	ofreciendo
el tranvia moderno recorre el centro historico ofreciendo MASK unicas de edificios	vistas
el tranvia moderno recorre el centro historico ofreciendo vistas MASK de edificios	unicas
el tranvia moderno recorre el centro historico ofreciendo vistas unicas MASK edificios	de
el tranvia moderno recorre el centro historico ofreciendo vistas unicas de MASK	edificios
MASK paella valenciana es mi plato espanol favorito por su sabor inigualable	la
la MASK valenciana es mi plato espanol favorito por su sabor inigualable	paella
la paella MASK es mi plato espanol favorito por su sabor inigualable	valenciana
la paella valenciana MASK mi plato espanol favorito por su sabor inigualable	es
la paella valenciana es MASK plato espanol favorito por su sabor inigualable	mi
la paella valenciana es mi MASK espanol favorito por su sabor inigualable	plato
la paella valenciana es mi plato MASK favorito por su sabor inigualable	espanol
la paella valenciana es mi plato espanol MASK por su sabor inigualable	favorito
la paella valenciana es mi plato espanol favorito MASK su sabor inigualable	por
la paella valenciana es mi plato espanol favorito por MASK sabor inigualable	su
la paella valenciana es mi plato espanol favorito por su MASK inigualable	sabor
la paella valenciana es mi plato espanol favorito por su sabor MASK	inigualable
MASK comprar tomates frescos aguacates y cebollas para hacer guacamole esta noche	necesito
necesito MASK tomates frescos aguacates y cebollas para hacer guacamole esta noche	comprar
necesito comprar MASK frescos aguacates y cebollas para hacer guacamole esta noche	tomates
necesito comprar tomates MASK aguacates y cebollas para hacer guacamole esta noche	frescos
necesito comprar tomates frescos MASK y cebollas para hacer guacamole esta noche	aguacates
necesito comprar tomates frescos aguacates MASK cebollas para hacer guacamole esta noche	y
necesito comprar tomates frescos aguacates y MASK para hacer guacamole esta noche	cebollas
necesito comprar tomates frescos aguacates y cebollas MASK hacer guacamole esta noche	para
necesito comprar tomates frescos aguacates y cebollas para MASK guacamole esta noche	hacer
necesito comprar tomates frescos aguacates y cebollas para hacer MASK esta noche	guacamole
necesito comprar tomates frescos aguacates y cebollas para hacer guacamole MASK noche	esta
necesito comprar tomates frescos aguacates y cebollas para hacer guacamole esta MASK	noche
MASK chef preparo una ensalada gourmet con ingredientes organicos de la huerta local	el
el MASK preparo una ensalada gourmet con ingredientes organicos de la huerta local	chef
el chef MASK una ensalada gourmet con ingredientes organicos de la huerta local	preparo
el chef preparo MASK ensalada gourmet con ingredientes organicos de la huerta local	una
el chef preparo una MASK gourmet con ingredientes organicos de la huerta local	ensalada
el chef preparo una ensalada MASK con ingredientes organicos de la huerta local	gourmet
el chef preparo una ensalada gourmet MASK ingredientes organicos de la huerta local	con
el chef preparo una ensalada gourmet con MASK organicos de la huerta local	ingredientes
el chef preparo una ensalada gourmet con ingredientes MASK de la huerta local	organicos
el chef preparo una ensalada gourmet con ingredientes organicos MASK la huerta local	de
el chef preparo una ensalada gourmet con ingredientes organicos de MASK huerta local	la
el chef preparo una ensalada gourmet con ingredientes organicos de la MASK local	huerta
el chef preparo una ensalada gourmet con ingredientes organicos de la huerta MASK	local
MASK encanta el olor del pan recien horneado por la manana temprano	me
me MASK el olor del pan recien horneado por la manana temprano	encanta
me encanta MASK olor del pan recien horneado por la manana temprano	el
me encanta el MASK del pan recien horneado por la manana temprano	olor
me encanta el olor MASK pan recien horneado por la manana temprano	del
me encanta el olor del MASK recien horneado por la manana temprano	pan
me encanta el olor del pan MASK horneado por la manana temprano	recien
me encanta el olor del pan recien MASK por la manana temprano	horneado
me encanta el olor del pan recien horneado MASK la manana temprano	por
me encanta el olor del pan recien horneado por MASK manana temprano	la
me encanta el olor del pan recien horneado por la MASK temprano	manana
me encanta el olor del pan recien horneado por la manana MASK	temprano
MASK receta de la abuela para el pastel de manzana es secreta siempre	la
la MASK de la abuela para el pastel de manzana es secreta siempre	receta
la receta MASK la abuela para el pastel de manzana es secreta siempre	de
la receta de MASK abuela para el pastel de manzana es secreta siempre	la
la receta de la MASK para el pastel de manzana es secreta siempre	abuela
la receta de la abuela MASK el pastel de manzana es secreta siempre	para
la receta de la abuela para MASK pastel de manzana es secreta siempre	el
la receta de la abuela para el MASK de manzana es secreta siempre	pastel
la receta de la abuela para el pastel MASK manzana es secreta siempre	de
la receta de la abuela para el pastel de MASK es secreta siempre	manzana
la receta de la abuela para el pastel de manzana MASK secreta siempre	es
la receta de la abuela para el pastel de manzana es MASK siempre	secreta
la receta de la abuela para el pastel de manzana es secreta MASK	siempre
MASK un tazon de cereales con fruta y yogur todos los dias	desayuno
desayuno MASK tazon de cereales con fruta y yogur todos los dias	un
desayuno un MASK de cereales con fruta y yogur todos los dias	tazon
desayuno un tazon MASK cereales con fruta y yogur todos los dias	de
desayuno un tazon de MASK con fruta y yogur todos los dias	cereales
desayuno un tazon de cereales MASK fruta y yogur todos los dias	con
desayuno un tazon de cereales con MASK y yogur todos los dias	fruta
desayuno un tazon de cereales con fruta MASK yogur todos los dias	y
desayuno un tazon de cereales con fruta y MASK todos los dias	yogur
desayuno un tazon de cereales con fruta y yogur MASK los dias	todos
desayuno un tazon de cereales con fruta y yogur todos MASK dias	los
desayuno un tazon de cereales con fruta y yogur todos los MASK	dias
MASK pizza a domicilio cuando no tenemos ganas de cocinar nada especial	pedimos
pedimos MASK a domicilio cuando no tenemos ganas de cocinar nada especial	pizza
pedimos pizza MASK domicilio cuando no tenemos ganas de cocinar nada especial	a
pedimos pizza a MASK cuando no tenemos ganas de cocinar nada especial	domicilio
pedimos pizza a domicilio MASK no tenemos ganas de cocinar nada especial	cuando
pedimos pizza a domicilio cuando MASK tenemos ganas de cocinar nada especial	no
pedimos pizza a domicilio cuando no MASK ganas de cocinar nada especial	tenemos
pedimos pizza a domicilio cuando no tenemos MASK de cocinar nada especial	ganas
pedimos pizza a domicilio cuando no tenemos ganas MASK cocinar nada especial	de
pedimos pizza a domicilio cuando no tenemos ganas de MASK nada especial	cocinar
pedimos pizza a domicilio cuando no tenemos ganas de cocinar MASK especial	nada
pedimos pizza a domicilio cuando no tenemos ganas de cocinar nada MASK	especial
MASK vino tinto acompana muy bien las carnes rojas y los quesos curados	el
el MASK tinto acompana muy bien las carnes rojas y los quesos curados	vino
el vino MASK acompana muy bien las carnes rojas y los quesos curados	tinto
el vino tinto MASK muy bien las carnes rojas y los quesos curados	acompana
el vino tinto acompana MASK bien las carnes rojas y los quesos curados	muy
el vino tinto acompana muy MASK las carnes rojas y los quesos curados	bien
el vino tinto acompana muy bien MASK carnes rojas y los quesos curados	las
el vino tinto acompana muy bien las MASK rojas y los quesos curados	carnes
el vino tinto acompana muy bien las carnes MASK y los quesos curados	rojas
el vino tinto acompana muy bien las carnes rojas MASK los quesos curados	y
el vino tinto acompana muy bien las carnes rojas y MASK quesos curados	los
el vino tinto acompana muy bien las carnes rojas y los MASK curados	quesos
el vino tinto acompana muy bien las carnes rojas y los quesos MASK	curados
MASK sopa de verduras caliente es reconfortante en los dias frios de invierno	la
la MASK de verduras caliente es reconfortante en los dias frios de invierno	sopa
la sopa MASK verduras caliente es reconfortante en los dias frios de invierno	de
la sopa de MASK caliente es reconfortante en los dias frios de invierno	verduras
la sopa de verduras MASK es reconfortante en los dias frios de invierno	caliente
la sopa de verduras caliente MASK reconfortante en los dias frios de invierno	es
la sopa de verduras caliente es MASK en los dias frios de invierno	reconfortante
la sopa de verduras caliente es reconfortante MASK los dias frios de invierno	en
la sopa de verduras caliente es reconfortante en MASK dias frios de invierno	los
la sopa de verduras caliente es reconfortante en los MASK frios de invierno	dias
la sopa de verduras caliente es reconfortante en los dias MASK de invierno	frios
la sopa de verduras caliente es reconfortante en los dias frios MASK invierno	de
la sopa de verduras caliente es reconfortante en los dias frios de MASK	invierno
MASK mercado local ofrece productos frescos y de temporada a buenos precios siempre	el
el MASK local ofrece productos frescos y de temporada a buenos precios siempre	mercado
el mercado MASK ofrece productos frescos y de temporada a buenos precios siempre	local
el mercado local MASK productos frescos y de temporada a buenos precios siempre	ofrece
el mercado local ofrece MASK frescos y de temporada a buenos precios siempre	productos
el mercado local ofrece productos MASK y de temporada a buenos precios siempre	frescos
el mercado local ofrece productos frescos MASK de temporada a buenos precios siempre	y
el mercado local ofrece productos frescos y MASK temporada a buenos precios siempre	de
el mercado local ofrece productos frescos y de MASK a buenos precios siempre	temporada
el mercado local ofrece productos frescos y de temporada MASK buenos precios siempre	a
el mercado local ofrece productos frescos y de temporada a MASK precios siempre	buenos
el mercado local ofrece productos frescos y de temporada a buenos MASK siempre	precios
el mercado local ofrece productos frescos y de temporada a buenos precios MASK	siempre
MASK profesor explica la leccion de matematicas con ejemplos claros en la pizarra	el
el MASK explica la leccion de matematicas con ejemplos claros en la pizarra	profesor
el profesor MASK la leccion de matematicas con ejemplos claros en la pizarra	explica
el profesor explica MASK leccion de matematicas con ejemplos claros en la pizarra	la
el profesor explica la MASK de matematicas con ejemplos claros en la pizarra	leccion
el profesor explica la leccion MASK matematicas con ejemplos claros en la pizarra	de
el profesor explica la leccion de MASK con ejemplos claros en la pizarra	matematicas
el profesor explica la leccion de matematicas MASK ejemplos claros en la pizarra	con
el profesor explica la leccion de matematicas con MASK claros en la pizarra	ejemplos
el profesor explica la leccion de matematicas con ejemplos MASK en la pizarra	claros
el profesor explica la leccion de matematicas con ejemplos claros MASK la pizarra	en
el profesor explica la leccion de matematicas con ejemplos claros en MASK pizarra	la
el profesor explica la leccion de matematicas con ejemplos claros en la MASK	pizarra
MASK estudiantes toman apuntes atentamente durante la conferencia del famoso historiador invitado	los
los MASK toman apuntes atentamente durante la conferencia del famoso historiador invitado	estudiantes
los estudiantes MASK apuntes atentamente durante la conferencia del famoso historiador invitado	toman
los estudiantes toman MASK atentamente durante la conferencia del famoso historiador invitado	apuntes
los estudiantes toman apuntes MASK durante la conferencia del famoso historiador invitado	atentamente
los estudiantes toman apuntes atentamente MASK la conferencia del famoso historiador invitado	durante
los estudiantes toman apuntes atentamente durante MASK conferencia del famoso historiador invitado	la
los estudiantes toman apuntes atentamente durante la MASK del famoso historiador invitado	conferencia
los estudiantes toman apuntes atentamente durante la conferencia MASK famoso historiador invitado	del
los estudiantes toman apuntes atentamente durante la conferencia del MASK historiador invitado	famoso
los estudiantes toman apuntes atentamente durante la conferencia del famoso MASK invitado	historiador
los estudiantes toman apuntes atentamente durante la conferencia del famoso historiador MASK	invitado
MASK biblioteca universitaria tiene miles de volumenes para consulta e investigacion profunda	la
la MASK universitaria tiene miles de volumenes para consulta e investigacion profunda	biblioteca
la biblioteca MASK tiene miles de volumenes para consulta e investigacion profunda	universitaria
la biblioteca universitaria MASK miles de volumenes para consulta e investigacion profunda	tiene
la biblioteca universitaria tiene MASK de volumenes para consulta e investigacion profunda	miles
la biblioteca universitaria tiene miles MASK volumenes para consulta e investigacion profunda	de
la biblioteca universitaria tiene miles de MASK para consulta e investigacion profunda	volumenes
la biblioteca universitaria tiene miles de volumenes MASK consulta e investigacion profunda	para
la biblioteca universitaria tiene miles de volumenes para MASK e investigacion profunda	consulta
la biblioteca universitaria tiene miles de volumenes para consulta MASK investigacion profunda	e
la biblioteca universitaria tiene miles de volumenes para consulta e MASK profunda	investigacion
la biblioteca universitaria tiene miles de volumenes para consulta e investigacion MASK	profunda
MASK el examen final requiere estudiar mucho y comprender todos los temas	aprobar
aprobar MASK examen final requiere estudiar mucho y comprender todos los temas	el
aprobar el MASK final requiere estudiar mucho y comprender todos los temas	examen
aprobar el examen MASK requiere estudiar mucho y comprender todos los temas	final
aprobar el examen final MASK estudiar mucho y comprender todos los temas	requiere
aprobar el examen final requiere MASK mucho y comprender todos los temas	estudiar
aprobar el examen final requiere estudiar MASK y comprender todos los temas	mucho
aprobar el examen final requiere estudiar mucho MASK comprender todos los temas	y
aprobar el examen final requiere estudiar mucho y MASK todos los temas	comprender
aprobar el examen final requiere estudiar mucho y comprender MASK los temas	todos
aprobar el examen final requiere estudiar mucho y comprender todos MASK temas	los
aprobar el examen final requiere estudiar mucho y comprender todos los MASK	temas
MASK sistema educativo debe fomentar el pensamiento critico y la creatividad siempre activa	el
el MASK educativo debe fomentar el pensamiento critico y la creatividad siempre activa	sistema
el sistema MASK debe fomentar el pensamiento critico y la creatividad siempre activa	educativo
el sistema educativo MASK fomentar el pensamiento critico y la creatividad siempre activa	debe
el sistema educativo debe MASK el pensamiento critico y la creatividad siempre activa	fomentar
el sistema educativo debe fomentar MASK pensamiento critico y la creatividad siempre activa	el
el sistema educativo debe fomentar el MASK critico y la creatividad siempre activa	pensamiento
el sistema educativo debe fomentar el pensamiento MASK y la creatividad siempre activa	critico
el sistema educativo debe fomentar el pensamiento critico MASK la creatividad siempre activa	y
el sistema educativo debe fomentar el pensamiento critico y MASK creatividad siempre activa	la
el sistema educativo debe fomentar el pensamiento critico y la MASK siempre activa	creatividad
el sistema educativo debe fomentar el pensamiento critico y la creatividad MASK activa	siempre
el sistema educativo debe fomentar el pensamiento critico y la creatividad siempre MASK	activa
MASK a un curso de idiomas para aprender frances y mejorar mi curriculum	asisto
asisto MASK un curso de idiomas para aprender frances y mejorar mi curriculum	a
asisto a MASK curso de idiomas para aprender frances y mejorar mi curriculum	un
asisto a un MASK de idiomas para aprender frances y mejorar mi curriculum	curso
asisto a un curso MASK idiomas para aprender frances y mejorar mi curriculum	de
asisto a un curso de MASK para aprender frances y mejorar mi curriculum	idiomas
asisto a un curso de idiomas MASK aprender frances y mejorar mi curriculum	para
asisto a un curso de idiomas para MASK frances y mejorar mi curriculum	aprender
asisto a un curso de idiomas para aprender MASK y mejorar mi curriculum	frances
asisto a un curso de idiomas para aprender frances MASK mejorar mi curriculum	y
asisto a un curso de idiomas para aprender frances y MASK mi curriculum	mejorar
asisto a un curso de idiomas para aprender frances y mejorar MASK curriculum	mi
asisto a un curso de idiomas para aprender frances y mejorar mi MASK	curriculum
MASK investigacion cientifica avanza gracias al esfuerzo de muchos equipos multidisciplinares dedicados	la
la MASK cientifica avanza gracias al esfuerzo de muchos equipos multidisciplinares dedicados	investigacion
la investigacion MASK avanza gracias al esfuerzo de muchos equipos multidisciplinares dedicados	cientifica
la investigacion cientifica MASK gracias al esfuerzo de muchos equipos multidisciplinares dedicados	avanza
la investigacion cientifica avanza MASK al esfuerzo de muchos equipos multidisciplinares dedicados	gracias
la investigacion cientifica avanza gracias MASK esfuerzo de muchos equipos multidisciplinares dedicados	al
la investigacion cientifica avanza gracias al MASK de muchos equipos multidisciplinares dedicados	esfuerzo
la investigacion cientifica avanza gracias al esfuerzo MASK muchos equipos multidisciplinares dedicados	de
la investigacion cientifica avanza gracias al esfuerzo de MASK equipos multidisciplinares dedicados	muchos
la investigacion cientifica avanza gracias al esfuerzo de muchos MASK multidisciplinares dedicados	equipos
la investigacion cientifica avanza gracias al esfuerzo de muchos equipos MASK dedicados	multidisciplinares
la investigacion cientifica avanza gracias al esfuerzo de muchos equipos multidisciplinares MASK	dedicados
MASK ninos aprenden jugando y explorando el mundo que les rodea diariamente	los
los MASK aprenden jugando y explorando el mundo que les rodea diariamente	ninos
los ninos MASK jugando y explorando el mundo que les rodea diariamente	aprenden
los ninos aprenden MASK y explorando el mundo que les rodea diariamente	jugando
los ninos aprenden jugando MASK explorando el mundo que les rodea diariamente	y
los ninos aprenden jugando y MASK el mundo que les rodea diariamente	explorando
los ninos aprenden jugando y explorando MASK mundo que les rodea diariamente	el
los ninos aprenden jugando y explorando el MASK que les rodea diariamente	mundo
los ninos aprenden jugando y explorando el mundo MASK les rodea diariamente	que
los ninos aprenden jugando y explorando el mundo que MASK rodea diariamente	les
los ninos aprenden jugando y explorando el mundo que les MASK diariamente	rodea
los ninos aprenden jugando y explorando el mundo que les rodea MASK	diariamente
MASK educacion continua es fundamental para el desarrollo profesional en cualquier area laboral	la
la MASK continua es fundamental para el desarrollo profesional en cualquier area laboral	educacion
la educacion MASK es fundamental para el desarrollo profesional en cualquier area laboral	continua
la educacion continua MASK fundamental para el desarrollo profesional en cualquier area laboral	es
la educacion continua es MASK para el desarrollo profesional en cualquier area laboral	fundamental
la educacion continua es fundamental MASK el desarrollo profesional en cualquier area laboral	para
la educacion continua es fundamental para MASK desarrollo profesional en cualquier area laboral	el
la educacion continua es fundamental para el MASK profesional en cualquier area laboral	desarrollo
la educacion continua es fundamental para el desarrollo MASK en cualquier area laboral	profesional
la educacion continua es fundamental para el desarrollo profesional MASK cualquier area laboral	en
la educacion continua es fundamental para el desarrollo profesional en MASK area laboral	cualquier
la educacion continua es fundamental para el desarrollo profesional en cualquier MASK laboral	area
la educacion continua es fundamental para el desarrollo profesional en cualquier area MASK	laboral
MASK universidad ofrece becas para estudiantes con excelente rendimiento academico cada ano	la
la MASK ofrece becas para estudiantes con excelente rendimiento academico cada ano	universidad
la universidad MASK becas para estudiantes con excelente rendimiento academico cada ano	ofrece
la universidad ofrece MASK para estudiantes con excelente rendimiento academico cada ano	becas
la universidad ofrece becas MASK estudiantes con excelente rendimiento academico cada ano	para
la universidad ofrece becas para MASK con excelente rendimiento academico cada ano	estudiantes
la universidad ofrece becas para estudiantes MASK excelente rendimiento academico cada ano	con
la universidad ofrece becas para estudiantes con MASK rendimiento academico cada ano	excelente
la universidad ofrece becas para estudiantes con excelente MASK academico cada ano	rendimiento
la universidad ofrece becas para estudiantes con excelente rendimiento MASK cada ano	academico
la universidad ofrece becas para estudiantes con excelente rendimiento academico MASK ano	cada
la universidad ofrece becas para estudiantes con excelente rendimiento academico cada MASK	ano
MASK ejercicio regularmente ayuda a mantener un peso saludable y prevenir enfermedades	hacer
hacer MASK regularmente ayuda a mantener un peso saludable y prevenir enfermedades	ejercicio
hacer ejercicio MASK ayuda a mantener un peso saludable y prevenir enfermedades	regularmente
hacer ejercicio regularmente MASK a mantener un peso saludable y prevenir enfermedades	ayuda
hacer ejercicio regularmente ayuda MASK mantener un peso saludable y prevenir enfermedades	a
hacer ejercicio regularmente ayuda a MASK un peso saludable y prevenir enfermedades	mantener
hacer ejercicio regularmente ayuda a mantener MASK peso saludable y prevenir enfermedades	un
hacer ejercicio regularmente ayuda a mantener un MASK saludable y prevenir enfermedades	peso
hacer ejercicio regularmente ayuda a mantener un peso MASK y prevenir enfermedades	saludable
hacer ejercicio regularmente ayuda a mantener un peso saludable MASK prevenir enfermedades	y
hacer ejercicio regularmente ayuda a mantener un peso saludable y MASK enfermedades	prevenir
hacer ejercicio regularmente ayuda a mantener un peso saludable y prevenir MASK	enfermedades
MASK dieta equilibrada rica en frutas y verduras es esencial para la salud	una
una MASK equilibrada rica en frutas y verduras es esencial para la salud	dieta
una dieta MASK rica en frutas y verduras es esencial para la salud	equilibrada
una dieta equilibrada MASK en frutas y verduras es esencial para la salud	rica
una dieta equilibrada rica MASK frutas y verduras es esencial para la salud	en
una dieta equilibrada rica en MASK y verduras es esencial para la salud	frutas
una dieta equilibrada rica en frutas MASK verduras es esencial para la salud	y
una dieta equilibrada rica en frutas y MASK es esencial para la salud	verduras
una dieta equilibrada rica en frutas y verduras MASK esencial para la salud	es
una dieta equilibrada rica en frutas y verduras es MASK para la salud	esencial
una dieta equilibrada rica en frutas y verduras es esencial MASK la salud	para
una dieta equilibrada rica en frutas y verduras es esencial para MASK salud	la
una dieta equilibrada rica en frutas y verduras es esencial para la MASK	salud
MASK ocho horas diarias es importante para la recuperacion fisica y mental	dormir
dormir MASK horas diarias es importante para la recuperacion fisica y mental	ocho
dormir ocho MASK diarias es importante para la recuperacion fisica y mental	horas
dormir ocho horas MASK es importante para la recuperacion fisica y mental	diarias
dormir ocho horas diarias MASK importante para la recuperacion fisica y mental	es
dormir ocho horas diarias es MASK para la recuperacion fisica y mental	importante
dormir ocho horas diarias es importante MASK la recuperacion fisica y mental	para
dormir ocho horas diarias es importante para MASK recuperacion fisica y mental	la
dormir ocho horas diarias es importante para la MASK fisica y mental	recuperacion
dormir ocho horas diarias es importante para la recuperacion MASK y mental	fisica
dormir ocho horas diarias es importante para la recuperacion fisica MASK mental	y
dormir ocho horas diarias es importante para la recuperacion fisica y MASK	mental
MASK medico me recomendo tomar vitaminas para fortalecer mi sistema inmunologico ahora	el
el MASK me recomendo tomar vitaminas para fortalecer mi sistema inmunologico ahora	medico
el medico MASK recomendo tomar vitaminas para fortalecer mi sistema inmunologico ahora	me
el medico me MASK tomar vitaminas para fortalecer mi sistema inmunologico ahora	recomendo
el medico me recomendo MASK vitaminas para fortalecer mi sistema inmunologico ahora	tomar
el medico me recomendo tomar MASK para fortalecer mi sistema inmunologico ahora	vitaminas
el medico me recomendo tomar vitaminas MASK fortalecer mi sistema inmunologico ahora	para
el medico me recomendo tomar vitaminas para MASK mi sistema inmunologico ahora	fortalecer
el medico me recomendo tomar vitaminas para fortalecer MASK sistema inmunologico ahora	mi
el medico me recomendo tomar vitaminas para fortalecer mi MASK inmunologico ahora	sistema
el medico me recomendo tomar vitaminas para fortalecer mi sistema MASK ahora	inmunologico
el medico me recomendo tomar vitaminas para fortalecer mi sistema inmunologico MASK	ahora
MASK prevencion es la mejor herramienta para evitar problemas de salud graves futuros	la
la MASK es la mejor herramienta para evitar problemas de salud graves futuros	prevencion
la prevencion MASK la mejor herramienta para evitar problemas de salud graves futuros	es
la prevencion es MASK mejor herramienta para evitar problemas de salud graves futuros	la
la prevencion es la MASK herramienta para evitar problemas de salud graves futuros	mejor
la prevencion es la mejor MASK para evitar problemas de salud graves futuros	herramienta
la prevencion es la mejor herramienta MASK evitar problemas de salud graves futuros	para
la prevencion es la mejor herramienta para MASK problemas de salud graves futuros	evitar
la prevencion es la mejor herramienta para evitar MASK de salud graves futuros	problemas
la prevencion es la mejor herramienta para evitar problemas MASK salud graves futuros	de
la prevencion es la mejor herramienta para evitar problemas de MASK graves futuros	salud
la prevencion es la mejor herramienta para evitar problemas de salud MASK futuros	graves
la prevencion es la mejor herramienta para evitar problemas de salud graves MASK	futuros
MASK al aire libre reduce el estres y mejora el estado de animo	caminar
caminar MASK aire libre reduce el estres y mejora el estado de animo	al
caminar al MASK libre reduce el estres y mejora el estado de animo	aire
caminar al aire MASK reduce el estres y mejora el estado de animo	libre
caminar al aire libre MASK el estres y mejora el estado de animo	reduce
caminar al aire libre reduce MASK estres y mejora el estado de animo	el
caminar al aire libre reduce el MASK y mejora el estado de animo	estres
caminar al aire libre reduce el estres MASK mejora el estado de animo	y
caminar al aire libre reduce el estres y MASK el estado de animo	mejora
caminar al aire libre reduce el estres y mejora MASK estado de animo	el
caminar al aire libre reduce el estres y mejora el MASK de animo	estado
caminar al aire libre reduce el estres y mejora el estado MASK animo	de
caminar al aire libre reduce el estres y mejora el estado de MASK	animo
MASK suficiente agua durante el dia es crucial para una buena hidratacion	beber
beber MASK agua durante el dia es crucial para una buena hidratacion	suficiente
beber suficiente MASK durante el dia es crucial para una buena hidratacion	agua
beber suficiente agua MASK el dia es crucial para una buena hidratacion	durante
beber suficiente agua durante MASK dia es crucial para una buena hidratacion	el
beber suficiente agua durante el MASK es crucial para una buena hidratacion	dia
beber suficiente agua durante el dia MASK crucial para una buena hidratacion	es
beber suficiente agua durante el dia es MASK para una buena hidratacion	crucial
beber suficiente agua durante el dia es crucial MASK una buena hidratacion	para
beber suficiente agua durante el dia es crucial para MASK buena hidratacion	una
beber suficiente agua durante el dia es crucial para una MASK hidratacion	buena
beber suficiente agua durante el dia es crucial para una buena MASK	hidratacion
MASK meditacion ayuda a calmar la mente y mejorar la concentracion notablemente	la
la MASK ayuda a calmar la mente y mejorar la concentracion notablemente	meditacion
la meditacion MASK a calmar la mente y mejorar la concentracion notablemente	ayuda
la meditacion ayuda MASK calmar la mente y mejorar la concentracion notablemente	a
la meditacion ayuda a MASK la mente y mejorar la concentracion notablemente	calmar
la meditacion ayuda a calmar MASK mente y mejorar la concentracion notablemente	la
la meditacion ayuda a calmar la MASK y mejorar la concentracion notablemente	mente
la meditacion ayuda a calmar la mente MASK mejorar la concentracion notablemente	y
la meditacion ayuda a calmar la mente y MASK la concentracion notablemente	mejorar
la meditacion ayuda a calmar la mente y mejorar MASK concentracion notablemente	la
la meditacion ayuda a calmar la mente y mejorar la MASK notablemente	concentracion
la meditacion ayuda a calmar la mente y mejorar la concentracion MASK	notablemente
MASK el consumo excesivo de azucar es beneficioso para la salud general	evitar
evitar MASK consumo excesivo de azucar es beneficioso para la salud general	el
evitar el MASK excesivo de azucar es beneficioso para la salud general	consumo
evitar el consumo MASK de azucar es beneficioso para la salud general	excesivo
evitar el consumo excesivo MASK azucar es beneficioso para la salud general	de
evitar el consumo excesivo de MASK es beneficioso para la salud general	azucar
evitar el consumo excesivo de azucar MASK beneficioso para la salud general	es
evitar el consumo excesivo de azucar es MASK para la salud general	beneficioso
evitar el consumo excesivo de azucar es beneficioso MASK la salud general	para
evitar el consumo excesivo de azucar es beneficioso para MASK salud general	la
evitar el consumo excesivo de azucar es beneficioso para la MASK general	salud
evitar el consumo excesivo de azucar es beneficioso para la salud MASK	general
MASK chequeos medicos periodicos permite detectar problemas a tiempo para solucionarlos mejor	realizar
realizar MASK medicos periodicos permite detectar problemas a tiempo para solucionarlos mejor	chequeos
realizar chequeos MASK periodicos permite detectar problemas a tiempo para solucionarlos mejor	medicos
realizar chequeos medicos MASK permite detectar problemas a tiempo para solucionarlos mejor	periodicos
realizar chequeos medicos periodicos MASK detectar problemas a tiempo para solucionarlos mejor	permite
realizar chequeos medicos periodicos permite MASK problemas a tiempo para solucionarlos mejor	detectar
realizar chequeos medicos periodicos permite detectar MASK a tiempo para solucionarlos mejor	problemas
realizar chequeos medicos periodicos permite detectar problemas MASK tiempo para solucionarlos mejor	a
realizar chequeos medicos periodicos permite detectar problemas a MASK para solucionarlos mejor	tiempo
realizar chequeos medicos periodicos permite detectar problemas a tiempo MASK solucionarlos mejor	para
realizar chequeos medicos periodicos permite detectar problemas a tiempo para MASK mejor	solucionarlos
realizar chequeos medicos periodicos permite detectar problemas a tiempo para solucionarlos MASK	mejor
MASK comunicacion abierta es clave para mantener relaciones fuertes y muy saludables siempre	la
la MASK abierta es clave para mantener relaciones fuertes y muy saludables siempre	comunicacion
la comunicacion MASK es clave para mantener relaciones fuertes y muy saludables siempre	abierta
la comunicacion abierta MASK clave para mantener relaciones fuertes y muy saludables siempre	es
la comunicacion abierta es MASK para mantener relaciones fuertes y muy saludables siempre	clave
la comunicacion abierta es clave MASK mantener relaciones fuertes y muy saludables siempre	para
la comunicacion abierta es clave para MASK relaciones fuertes y muy saludables siempre	mantener
la comunicacion abierta es clave para mantener MASK fuertes y muy saludables siempre	relaciones
la comunicacion abierta es clave para mantener relaciones MASK y muy saludables siempre	fuertes
la comunicacion abierta es clave para mantener relaciones fuertes MASK muy saludables siempre	y
la comunicacion abierta es clave para mantener relaciones fuertes y MASK saludables siempre	muy
la comunicacion abierta es clave para mantener relaciones fuertes y muy MASK siempre	saludables
la comunicacion abierta es clave para mantener relaciones fuertes y muy saludables MASK	siempre
MASK hermanos y yo nos reunimos en casa de nuestros padres cada navidad	mis
mis MASK y yo nos reunimos en casa de nuestros padres cada navidad	hermanos
mis hermanos MASK yo nos reunimos en casa de nuestros padres cada navidad	y
mis hermanos y MASK nos reunimos en casa de nuestros padres cada navidad	yo
mis hermanos y yo MASK reunimos en casa de nuestros padres cada navidad	nos
mis hermanos y yo nos MASK en casa de nuestros padres cada navidad	reunimos
mis hermanos y yo nos reunimos MASK casa de nuestros padres cada navidad	en
mis hermanos y yo nos reunimos en MASK de nuestros padres cada navidad	casa
mis hermanos y yo nos reunimos en casa MASK nuestros padres cada navidad	de
mis hermanos y yo nos reunimos en casa de MASK padres cada navidad	nuestros
mis hermanos y yo nos reunimos en casa de nuestros MASK cada navidad	padres
mis hermanos y yo nos reunimos en casa de nuestros padres MASK navidad	cada
mis hermanos y yo nos reunimos en casa de nuestros padres cada MASK	navidad
MASK amigos verdaderos te apoyan en los momentos dificiles y celebran tus exitos	los
los MASK verdaderos te apoyan en los momentos dificiles y celebran tus exitos	amigos
los amigos MASK te apoyan en los momentos dificiles y celebran tus exitos	verdaderos
los amigos verdaderos MASK apoyan en los momentos dificiles y celebran tus exitos	te
los amigos verdaderos te MASK en los momentos dificiles y celebran tus exitos	apoyan
los amigos verdaderos te apoyan MASK los momentos dificiles y celebran tus exitos	en
los amigos verdaderos te apoyan en MASK momentos dificiles y celebran tus exitos	los
los amigos verdaderos te apoyan en los MASK dificiles y celebran tus exitos	momentos
los amigos verdaderos te apoyan en los momentos MASK y celebran tus exitos	dificiles
los amigos verdaderos te apoyan en los momentos dificiles MASK celebran tus exitos	y
los amigos verdaderos te apoyan en los momentos dificiles y MASK tus exitos	celebran
los amigos verdaderos te apoyan en los momentos dificiles y celebran MASK exitos	tus
los amigos verdaderos te apoyan en los momentos dificiles y celebran tus MASK	exitos
MASK confianza mutua es la base de cualquier relacion personal o profesional duradera	la
la MASK mutua es la base de cualquier relacion personal o profesional duradera	confianza
la confianza MASK es la base de cualquier relacion personal o profesional duradera	mutua
la confianza mutua MASK la base de cualquier relacion personal o profesional duradera	es
la confianza mutua es MASK base de cualquier relacion personal o profesional duradera	la
la confianza mutua es la MASK de cualquier relacion personal o profesional duradera	base
la confianza mutua es la base MASK cualquier relacion personal o profesional duradera	de
la confianza mutua es la base de MASK relacion personal o profesional duradera	cualquier
la confianza mutua es la base de cualquier MASK personal o profesional duradera	relacion
la confianza mutua es la base de cualquier relacion MASK o profesional duradera	personal
la confianza mutua es la base de cualquier relacion personal MASK profesional duradera	o
la confianza mutua es la base de cualquier relacion personal o MASK duradera	profesional
la confianza mutua es la base de cualquier relacion personal o profesional MASK	duradera
MASK tiempo de calidad con la familia fortalece los lazos afectivos entre todos	pasar
pasar MASK de calidad con la familia fortalece los lazos afectivos entre todos	tiempo
pasar tiempo MASK calidad con la familia fortalece los lazos afectivos entre todos	de
pasar tiempo de MASK con la familia fortalece los lazos afectivos entre todos	calidad
pasar tiempo de calidad MASK la familia fortalece los lazos afectivos entre todos	con
pasar tiempo de calidad con MASK familia fortalece los lazos afectivos entre todos	la
pasar tiempo de calidad con la MASK fortalece los lazos afectivos entre todos	familia
pasar tiempo de calidad con la familia MASK los lazos afectivos entre todos	fortalece
pasar tiempo de calidad con la familia fortalece MASK lazos afectivos entre todos	los
pasar tiempo de calidad con la familia fortalece los MASK afectivos entre todos	lazos
pasar tiempo de calidad con la familia fortalece los lazos MASK entre todos	afectivos
pasar tiempo de calidad con la familia fortalece los lazos afectivos MASK todos	entre
pasar tiempo de calidad con la familia fortalece los lazos afectivos entre MASK	todos
MASK respeto por las opiniones de los demas es fundamental para la convivencia	el
el MASK por las opiniones de los demas es fundamental para la convivencia	respeto
el respeto MASK las opiniones de los demas es fundamental para la convivencia	por
el respeto por MASK opiniones de los demas es fundamental para la convivencia	las
el respeto por las MASK de los demas es fundamental para la convivencia	opiniones
el respeto por las opiniones MASK los demas es fundamental para la convivencia	de
el respeto por las opiniones de MASK demas es fundamental para la convivencia	los
el respeto por las opiniones de los MASK es fundamental para la convivencia	demas
el respeto por las opiniones de los demas MASK fundamental para la convivencia	es
el respeto por las opiniones de los demas es MASK para la convivencia	fundamental
el respeto por las opiniones de los demas es fundamental MASK la convivencia	para
el respeto por las opiniones de los demas es fundamental para MASK convivencia	la
el respeto por las opiniones de los demas es fundamental para la MASK	convivencia
MASK los cumpleanos juntos es una tradicion importante en nuestra gran familia	celebrar
celebrar MASK cumpleanos juntos es una tradicion importante en nuestra gran familia	los
celebrar los MASK juntos es una tradicion importante en nuestra gran familia	cumpleanos
celebrar los cumpleanos MASK es una tradicion importante en nuestra gran familia	juntos
celebrar los cumpleanos juntos MASK una tradicion importante en nuestra gran familia	es
celebrar los cumpleanos juntos es MASK tradicion importante en nuestra gran familia	una
celebrar los cumpleanos juntos es una MASK importante en nuestra gran familia	tradicion
celebrar los cumpleanos juntos es una tradicion MASK en nuestra gran familia	importante
celebrar los cumpleanos juntos es una tradicion importante MASK nuestra gran familia	en
celebrar los cumpleanos juntos es una tradicion importante en MASK gran familia	nuestra
celebrar los cumpleanos juntos es una tradicion importante en nuestra MASK familia	gran
celebrar los cumpleanos juntos es una tradicion importante en nuestra gran MASK	familia
MASK activamente a los demas demuestra interes y tambien mucha empatia sincera	escuchar
escuchar MASK a los demas demuestra interes y tambien mucha empatia sincera	activamente
escuchar activamente MASK los demas demuestra interes y tambien mucha empatia sincera	a
escuchar activamente a MASK demas demuestra interes y tambien mucha empatia sincera	los
escuchar activamente a los MASK demuestra interes y tambien mucha empatia sincera	demas
escuchar activamente a los demas MASK interes y tambien mucha empatia sincera	demuestra
escuchar activamente a los demas demuestra MASK y tambien mucha empatia sincera	interes
escuchar activamente a los demas demuestra interes MASK tambien mucha empatia sincera	y
escuchar activamente a los demas demuestra interes y MASK mucha empatia sincera	tambien
escuchar activamente a los demas demuestra interes y tambien MASK empatia sincera	mucha
escuchar activamente a los demas demuestra interes y tambien mucha MASK sincera	empatia
escuchar activamente a los demas demuestra interes y tambien mucha empatia MASK	sincera
MASK a un amigo en apuros es un gesto de verdadera amistad	ayudar
ayudar MASK un amigo en apuros es un gesto de verdadera amistad	a
ayudar a MASK amigo en apuros es un gesto de verdadera amistad	un
ayudar a un MASK en apuros es un gesto de verdadera amistad	amigo
ayudar a un amigo MASK apuros es un gesto de verdadera amistad	en
ayudar a un amigo en MASK es un gesto de verdadera amistad	apuros
ayudar a un amigo en apuros MASK un gesto de verdadera amistad	es
ayudar a un amigo en apuros es MASK gesto de verdadera amistad	un
ayudar a un amigo en apuros es un MASK de verdadera amistad	gesto
ayudar a un amigo en apuros es un gesto MASK verdadera amistad	de
ayudar a un amigo en apuros es un gesto de MASK amistad	verdadera
ayudar a un amigo en apuros es un gesto de verdadera MASK	amistad
MASK discusiones constructivas pueden ayudar a resolver conflictos y mejorar las relaciones interpersonales	las
las MASK constructivas pueden ayudar a resolver conflictos y mejorar las relaciones interpersonales	discusiones
las discusiones MASK pueden ayudar a resolver conflictos y mejorar las relaciones interpersonales	constructivas
las discusiones constructivas MASK ayudar a resolver conflictos y mejorar las relaciones interpersonales	pueden
las discusiones constructivas pueden MASK a resolver conflictos y mejorar las relaciones interpersonales	ayudar
las discusiones constructivas pueden ayudar MASK resolver conflictos y mejorar las relaciones interpersonales	a
las discusiones constructivas pueden ayudar a MASK conflictos y mejorar las relaciones interpersonales	resolver
las discusiones constructivas pueden ayudar a resolver MASK y mejorar las relaciones interpersonales	conflictos
las discusiones constructivas pueden ayudar a resolver conflictos MASK mejorar las relaciones interpersonales	y
las discusiones constructivas pueden ayudar a resolver conflictos y MASK las relaciones interpersonales	mejorar
las discusiones constructivas pueden ayudar a resolver conflictos y mejorar MASK relaciones interpersonales	las
las discusiones constructivas pueden ayudar a resolver conflictos y mejorar las MASK interpersonales	relaciones
las discusiones constructivas pueden ayudar a resolver conflictos y mejorar las relaciones MASK	interpersonales
MASK nuevo telefono inteligente tiene una camara con resolucion muy alta y zoom, el
el MASK telefono inteligente tiene una camara con resolucion muy alta y zoom, nuevo
el nuevo MASK inteligente tiene una camara con resolucion muy alta y zoom, telefono
el nuevo telefono MASK tiene una camara con resolucion muy alta y zoom, inteligente
el nuevo telefono inteligente MASK una camara con resolucion muy alta y zoom, tiene
el nuevo telefono inteligente tiene MASK camara con resolucion muy alta y zoom, una
el nuevo telefono inteligente tiene una MASK con resolucion muy alta y zoom, camara
el nuevo telefono inteligente tiene una camara MASK resolucion muy alta y zoom, con
el nuevo telefono inteligente tiene una camara con MASK muy alta y zoom, resolucion
el nuevo telefono inteligente tiene una camara con resolucion MASK alta y zoom, muy
el nuevo telefono inteligente tiene una camara con resolucion muy MASK y zoom, alta
el nuevo telefono inteligente tiene una camara con resolucion muy alta MASK zoom, y
el nuevo telefono inteligente tiene una camara con resolucion muy alta y MASK, zoom
MASK computadora portatil necesita una bateria nueva porque se descarga muy rapido ahora, la
la MASK portatil necesita una bateria nueva porque se descarga muy rapido ahora, computadora
la computadora MASK necesita una bateria nueva porque se descarga muy rapido ahora, portatil
la computadora portatil MASK una bateria nueva porque se descarga muy rapido ahora, necesita
la computadora portatil necesita MASK bateria nueva porque se descarga muy rapido ahora, una
la computadora portatil necesita una MASK nueva porque se descarga muy rapido ahora, bateria
la computadora portatil necesita una bateria MASK porque se descarga muy rapido ahora, nueva
la computadora portatil necesita una bateria nueva MASK se descarga muy rapido ahora, porque
la computadora portatil necesita una bateria nueva porque MASK descarga muy rapido ahora, se
la computadora portatil necesita una bateria nueva porque se MASK muy rapido ahora, descarga
la computadora portatil necesita una bateria nueva porque se descarga MASK rapido ahora, muy
la computadora portatil necesita una bateria nueva porque se descarga muy MASK ahora, rapido
la computadora portatil necesita una bateria nueva porque se descarga muy rapido MASK, ahora
MASK una aplicacion util para editar fotografias directamente en mi tableta digital, descargue
descargue MASK aplicacion util para editar fotografias directamente en mi tableta digital, una
descargue una MASK util para editar fotografias directamente en mi tableta digital, aplicacion
descargue una aplicacion MASK para editar fotografias directamente en mi tableta digital, util
descargue una aplicacion util MASK editar fotografias directamente en mi tableta digital, para
descargue una aplicacion util para MASK fotografias directamente en mi tableta digital, editar
descargue una aplicacion util para editar MASK directamente en mi tableta digital, fotografias
descargue una aplicacion util para editar fotografias MASK en mi tableta digital, directamente
descargue una aplicacion util para editar fotografias directamente MASK mi tableta digital, en
descargue una aplicacion util para editar fotografias directamente en MASK tableta digital, mi
descargue una aplicacion util para editar fotografias directamente en mi MASK digital, tableta
descargue una aplicacion util para editar fotografias directamente en mi tableta MASK, digital
MASK conexion a internet en casa es bastante rapida para ver peliculas online, la
la MASK a internet en casa es bastante rapida para ver peliculas online, conexion
la conexion MASK internet en casa es bastante rapida para ver peliculas online, a
la conexion a MASK en casa es bastante rapida para ver peliculas online, internet
la conexion a internet MASK casa es bastante rapida para ver peliculas online, en
la conexion a internet en MASK es bastante rapida para ver peliculas online, casa
la conexion a internet en casa MASK bastante rapida para ver peliculas online, es
la conexion a internet en casa es MASK rapida para ver peliculas online, bastante
la conexion a internet en casa es bastante MASK para ver peliculas online, rapida
la conexion a internet en casa es bastante rapida MASK ver peliculas online, para
la conexion a internet en casa es bastante rapida para MASK peliculas online, ver
la conexion a internet en casa es bastante rapida para ver MASK online, peliculas
la conexion a internet en casa es bastante rapida para ver peliculas MASK, online
MASK auriculares inalambricos con cancelacion de ruido son perfectos para viajar en avion, los
los MASK inalambricos con cancelacion de ruido son perfectos para viajar en avion, auriculares
los auriculares MASK con cancelacion de ruido son perfectos para viajar en avion, inalambricos
los auriculares inalambricos MASK cancelacion de ruido son perfectos para viajar en avion, con
los auriculares inalambricos con MASK de ruido son perfectos para viajar en avion, cancelacion
los auriculares inalambricos con cancelacion MASK ruido son perfectos para viajar en avion, de
los auriculares inalambricos con cancelacion de MASK son perfectos para viajar en avion, ruido
los auriculares inalambricos con cancelacion de ruido MASK perfectos para viajar en avion, son
los auriculares inalambricos con cancelacion de ruido son MASK para viajar en avion, perfectos
los auriculares inalambricos con cancelacion de ruido son perfectos MASK viajar en avion, para
los auriculares inalambricos con cancelacion de ruido son perfectos para MASK en avion, viajar
los auriculares inalambricos con cancelacion de ruido son perfectos para viajar MASK avion, en
los auriculares inalambricos con cancelacion de ruido son perfectos para viajar en MASK, avion
MASK reloj inteligente monitoriza mi actividad fisica y tambien mi calidad de sueno, el
el MASK inteligente monitoriza mi actividad fisica y tambien mi calidad de sueno, reloj
el reloj MASK monitoriza mi actividad fisica y tambien mi calidad de sueno, inteligente
el reloj inteligente MASK mi actividad fisica y tambien mi calidad de sueno, monitoriza
el reloj inteligente monitoriza MASK actividad fisica y tambien mi calidad de sueno, mi
el reloj inteligente monitoriza mi MASK fisica y tambien mi calidad de sueno, actividad
el reloj inteligente monitoriza mi actividad MASK y tambien mi calidad de sueno, fisica
el reloj inteligente monitoriza mi actividad fisica MASK tambien mi calidad de sueno, y
el reloj inteligente monitoriza mi actividad fisica y MASK mi calidad de sueno, tambien
el reloj inteligente monitoriza mi actividad fisica y tambien MASK calidad de sueno, mi
el reloj inteligente monitoriza mi actividad fisica y tambien mi MASK de sueno, calidad
el reloj inteligente monitoriza mi actividad fisica y tambien mi calidad MASK sueno, de
el reloj inteligente monitoriza mi actividad fisica y tambien mi calidad de MASK, sueno
MASK impresora tres de puede crear objetos solidos a partir de disenos digitales, la
la MASK tres de puede crear objetos solidos a partir de disenos digitales, impresora
la impresora MASK de puede crear objetos solidos a partir de disenos digitales, tres
la impresora tres MASK puede crear objetos solidos a partir de disenos digitales, de
la impresora tres de MASK crear objetos solidos a partir de disenos digitales, puede
la impresora tres de puede MASK objetos solidos a partir de disenos digitales, crear
la impresora tres de puede crear MASK solidos a partir de disenos digitales, objetos
la impresora tres de puede crear objetos MASK a partir de disenos digitales, solidos
la impresora tres de puede crear objetos solidos MASK partir de disenos digitales, a
la impresora tres de puede crear objetos solidos a MASK de disenos digitales, partir
la impresora tres de puede crear objetos solidos a partir MASK disenos digitales, de
la impresora tres de puede crear objetos solidos a partir de MASK digitales, disenos
la impresora tres de puede crear objetos solidos a partir de disenos MASK, digitales
MASK el software del sistema operativo mejora la seguridad y el rendimiento general, actualizar
actualizar MASK software del sistema operativo mejora la seguridad y el rendimiento general, el
actualizar el MASK del sistema operativo mejora la seguridad y el rendimiento general, software
actualizar el software MASK sistema operativo mejora la seguridad y el rendimiento general, del
actualizar el software del MASK operativo mejora la seguridad y el rendimiento general, sistema
actualizar el software del sistema MASK mejora la seguridad y el rendimiento general, operativo
actualizar el software del sistema operativo MASK la seguridad y el rendimiento general, mejora
actualizar el software del sistema operativo mejora MASK seguridad y el rendimiento general, la
actualizar el software del sistema operativo mejora la MASK y el rendimiento general, seguridad
actualizar el software del sistema operativo mejora la seguridad MASK el rendimiento general, y
actualizar el software del sistema operativo mejora la seguridad y MASK rendimiento general, el
actualizar el software del sistema operativo mejora la seguridad y el MASK general, rendimiento
actualizar el software del sistema operativo mejora la seguridad y el rendimiento MASK, general
MASK almacenamiento en la nube permite acceder a mis archivos desde cualquier dispositivo, el
el MASK en la nube permite acceder a mis archivos desde cualquier dispositivo, almacenamiento
el almacenamiento MASK la nube permite acceder a mis archivos desde cualquier dispositivo, en
el almacenamiento en MASK nube permite acceder a mis archivos desde cualquier dispositivo, la
el almacenamiento en la MASK permite acceder a mis archivos desde cualquier dispositivo, nube
el almacenamiento en la nube MASK acceder a mis archivos desde cualquier dispositivo, permite
el almacenamiento en la nube permite MASK a mis archivos desde cualquier dispositivo, acceder
el almacenamiento en la nube permite acceder MASK mis archivos desde cualquier dispositivo, a
el almacenamiento en la nube permite acceder a MASK archivos desde cualquier dispositivo, mis
el almacenamiento en la nube permite acceder a mis MASK desde cualquier dispositivo, archivos
el almacenamiento en la nube permite acceder a mis archivos MASK cualquier dispositivo, desde
el almacenamiento en la nube permite acceder a mis archivos desde MASK dispositivo, cualquier
el almacenamiento en la nube permite acceder a mis archivos desde cualquier MASK, dispositivo
MASK inteligencia artificial esta transformando muchas industrias y tambien diversos sectores productivos globales, la
la MASK artificial esta transformando muchas industrias y tambien diversos sectores productivos globales, inteligencia
la inteligencia MASK esta transformando muchas industrias y tambien diversos sectores productivos globales, artificial
la inteligencia artificial MASK transformando muchas industrias y tambien diversos sectores productivos globales, esta
la inteligencia artificial esta MASK muchas industrias y tambien diversos sectores productivos globales, transformando
la inteligencia artificial esta transformando MASK industrias y tambien diversos sectores productivos globales, muchas
la inteligencia artificial esta transformando muchas MASK y tambien diversos sectores productivos globales, industrias
la inteligencia artificial esta transformando muchas industrias MASK tambien diversos sectores productivos globales, y
la inteligencia artificial esta transformando muchas industrias y MASK diversos sectores productivos globales, tambien
la inteligencia artificial esta transformando muchas industrias y tambien MASK sectores productivos globales, diversos
la inteligencia artificial esta transformando muchas industrias y tambien diversos MASK productivos globales, sectores
la inteligencia artificial esta transformando muchas industrias y tambien diversos sectores MASK globales, productivos
la inteligencia artificial esta transformando muchas industrias y tambien diversos sectores productivos MASK, globales
MASK proximo verano planeamos un viaje largo por varios paises del sudeste asiatico, el
el MASK verano planeamos un viaje largo por varios paises del sudeste asiatico, proximo
el proximo MASK planeamos un viaje largo por varios paises del sudeste asiatico, verano
el proximo verano MASK un viaje largo por varios paises del sudeste asiatico, planeamos
el proximo verano planeamos MASK viaje largo por varios paises del sudeste asiatico, un
el proximo verano planeamos un MASK largo por varios paises del sudeste asiatico, viaje
el proximo verano planeamos un viaje MASK por varios paises del sudeste asiatico, largo
el proximo verano planeamos un viaje largo MASK varios paises del sudeste asiatico, por
el proximo verano planeamos un viaje largo por MASK paises del sudeste asiatico, varios
el proximo verano planeamos un viaje largo por varios MASK del sudeste asiatico, paises
el proximo verano planeamos un viaje largo por varios paises MASK sudeste asiatico, del
el proximo verano planeamos un viaje largo por varios paises del MASK asiatico, sudeste
el proximo verano planeamos un viaje largo por varios paises del sudeste MASK, asiatico
MASK las ruinas antiguas de una civilizacion perdida en nuestro ultimo viaje cultural, visitamos
visitamos MASK ruinas antiguas de una civilizacion perdida en nuestro ultimo viaje cultural, las
visitamos las MASK antiguas de una civilizacion perdida en nuestro ultimo viaje cultural, ruinas
visitamos las ruinas MASK de una civilizacion perdida en nuestro ultimo viaje cultural, antiguas
visitamos las ruinas antiguas MASK una civilizacion perdida en nuestro ultimo viaje cultural, de
visitamos las ruinas antiguas de MASK civilizacion perdida en nuestro ultimo viaje cultural, una
visitamos las ruinas antiguas de una MASK perdida en nuestro ultimo viaje cultural, civilizacion
visitamos las ruinas antiguas de una civilizacion MASK en nuestro ultimo viaje cultural, perdida
visitamos las ruinas antiguas de una civilizacion perdida MASK nuestro ultimo viaje cultural, en
visitamos las ruinas antiguas de una civilizacion perdida en MASK ultimo viaje cultural, nuestro
visitamos las ruinas antiguas de una civilizacion perdida en nuestro MASK viaje cultural, ultimo
visitamos las ruinas antiguas de una civilizacion perdida en nuestro ultimo MASK cultural, viaje
visitamos las ruinas antiguas de una civilizacion perdida en nuestro ultimo viaje MASK, cultural
MASK guia turistica nos mostro los lugares mas emblematicos de la ciudad historica, la
la MASK turistica nos mostro los lugares mas emblematicos de la ciudad historica, guia
la guia MASK nos mostro los lugares mas emblematicos de la ciudad historica, turistica
la guia turistica MASK mostro los lugares mas emblematicos de la ciudad historica, nos
la guia turistica nos MASK los lugares mas emblematicos de la ciudad historica, mostro
la guia turistica nos mostro MASK lugares mas emblematicos de la ciudad historica, los
la guia turistica nos mostro los MASK mas emblematicos de la ciudad historica, lugares
la guia turistica nos mostro los lugares MASK emblematicos de la ciudad historica, mas
la guia turistica nos mostro los lugares mas MASK de la ciudad historica, emblematicos
la guia turistica nos mostro los lugares mas emblematicos MASK la ciudad historica, de
la guia turistica nos mostro los lugares mas emblematicos de MASK ciudad historica, la
la guia turistica nos mostro los lugares mas emblematicos de la MASK historica, ciudad
la guia turistica nos mostro los lugares mas emblematicos de la ciudad MASK, historica
MASK de la gastronomia local probando platos exoticos y bebidas tradicionales unicas, disfrutamos
disfrutamos MASK la gastronomia local probando platos exoticos y bebidas tradicionales unicas, de
disfrutamos de MASK gastronomia local probando platos exoticos y bebidas tradicionales unicas, la
disfrutamos de la MASK local probando platos exoticos y bebidas tradicionales unicas, gastronomia
disfrutamos de la gastronomia MASK probando platos exoticos y bebidas tradicionales unicas, local
disfrutamos de la gastronomia local MASK platos exoticos y bebidas tradicionales unicas, probando
disfrutamos de la gastronomia local probando MASK exoticos y bebidas tradicionales unicas, platos
disfrutamos de la gastronomia local probando platos MASK y bebidas tradicionales unicas, exoticos
disfrutamos de la gastronomia local probando platos exoticos MASK bebidas tradicionales unicas, y
disfrutamos de la gastronomia local probando platos exoticos y MASK tradicionales unicas, bebidas
disfrutamos de la gastronomia local probando platos exoticos y bebidas MASK unicas, tradicionales
disfrutamos de la gastronomia local probando platos exoticos y bebidas tradicionales MASK, unicas
MASK alojamos en un hotel pequeno con vistas espectaculares al mar mediterraneo azul, nos
nos MASK en un hotel pequeno con vistas espectaculares al mar mediterraneo azul, alojamos
nos alojamos MASK un hotel pequeno con vistas espectaculares al mar mediterraneo azul, en
nos alojamos en MASK hotel pequeno con vistas espectaculares al mar mediterraneo azul, un
nos alojamos en un MASK pequeno con vistas espectaculares al mar mediterraneo azul, hotel
nos alojamos en un hotel MASK con vistas espectaculares al mar mediterraneo azul, pequeno
nos alojamos en un hotel pequeno MASK vistas espectaculares al mar mediterraneo azul, con
nos alojamos en un hotel pequeno con MASK espectaculares al mar mediterraneo azul, vistas
nos alojamos en un hotel pequeno con vistas MASK al mar mediterraneo azul, espectaculares
nos alojamos en un hotel pequeno con vistas espectaculares MASK mar mediterraneo azul, al
nos alojamos en un hotel pequeno con vistas espectaculares al MASK mediterraneo azul, mar
nos alojamos en un hotel pequeno con vistas espectaculares al mar MASK azul, mediterraneo
nos alojamos en un hotel pequeno con vistas espectaculares al mar mediterraneo MASK, azul
MASK recuerdos tipicos para nuestros amigos y familiares en el mercado artesanal local, compramos
compramos MASK tipicos para nuestros amigos y familiares en el mercado artesanal local, recuerdos
compramos recuerdos MASK para nuestros amigos y familiares en el mercado artesanal local, tipicos
compramos recuerdos tipicos MASK nuestros amigos y familiares en el mercado artesanal local, para
compramos recuerdos tipicos para MASK amigos y familiares en el mercado artesanal local, nuestros
compramos recuerdos tipicos para nuestros MASK y familiares en el mercado artesanal local, amigos
compramos recuerdos tipicos para nuestros amigos MASK familiares en el mercado artesanal local, y
compramos recuerdos tipicos para nuestros amigos y MASK en el mercado artesanal local, familiares
compramos recuerdos tipicos para nuestros amigos y familiares MASK el mercado artesanal local, en
compramos recuerdos tipicos para nuestros amigos y familiares en MASK mercado artesanal local, el
compramos recuerdos tipicos para nuestros amigos y familiares en el MASK artesanal local, mercado
compramos recuerdos tipicos para nuestros amigos y familiares en el mercado MASK local, artesanal
compramos recuerdos tipicos para nuestros amigos y familiares en el mercado artesanal MASK, local
MASK nuevas culturas y conocer gente diferente enriquece mucho la experiencia vital, explorar
explorar MASK culturas y conocer gente diferente enriquece mucho la experiencia vital, nuevas
explorar nuevas MASK y conocer gente diferente enriquece mucho la experiencia vital, culturas
explorar nuevas culturas MASK conocer gente diferente enriquece mucho la experiencia vital, y
explorar nuevas culturas y MASK gente diferente enriquece mucho la experiencia vital, conocer
explorar nuevas culturas y conocer MASK diferente enriquece mucho la experiencia vital, gente
explorar nuevas culturas y conocer gente MASK enriquece mucho la experiencia vital, diferente
explorar nuevas culturas y conocer gente diferente MASK mucho la experiencia vital, enriquece
explorar nuevas culturas y conocer gente diferente enriquece MASK la experiencia vital, mucho
explorar nuevas culturas y conocer gente diferente enriquece mucho MASK experiencia vital, la
explorar nuevas culturas y conocer gente diferente enriquece mucho la MASK vital, experiencia
explorar nuevas culturas y conocer gente diferente enriquece mucho la experiencia MASK, vital
MASK reserva de vuelos y hoteles por internet facilita la planificacion de viajes, la
la MASK de vuelos y hoteles por internet facilita la planificacion de viajes, reserva
la reserva MASK vuelos y hoteles por internet facilita la planificacion de viajes, de
la reserva de MASK y hoteles por internet facilita la planificacion de viajes, vuelos
la reserva de vuelos MASK hoteles por internet facilita la planificacion de viajes, y
la reserva de vuelos y MASK por internet facilita la planificacion de viajes, hoteles
la reserva de vuelos y hoteles MASK internet facilita la planificacion de viajes, por
la reserva de vuelos y hoteles por MASK facilita la planificacion de viajes, internet
la reserva de vuelos y hoteles por internet MASK la planificacion de viajes, facilita
la reserva de vuelos y hoteles por internet facilita MASK planificacion de viajes, la
la reserva de vuelos y hoteles por internet facilita la MASK de viajes, planificacion
la reserva de vuelos y hoteles por internet facilita la planificacion MASK viajes, de
la reserva de vuelos y hoteles por internet facilita la planificacion de MASK, viajes
MASK fotografias de paisajes impresionantes es mi parte favorita de cada viaje largo, tomar
tomar MASK de paisajes impresionantes es mi parte favorita de cada viaje largo, fotografias
tomar fotografias MASK paisajes impresionantes es mi parte favorita de cada viaje largo, de
tomar fotografias de MASK impresionantes es mi parte favorita de cada viaje largo, paisajes
tomar fotografias de paisajes MASK es mi parte favorita de cada viaje largo, impresionantes
tomar fotografias de paisajes impresionantes MASK mi parte favorita de cada viaje largo, es
tomar fotografias de paisajes impresionantes es MASK parte favorita de cada viaje largo, mi
tomar fotografias de paisajes impresionantes es mi MASK favorita de cada viaje largo, parte
tomar fotografias de paisajes impresionantes es mi parte MASK de cada viaje largo, favorita
tomar fotografias de paisajes impresionantes es mi parte favorita MASK cada viaje largo, de
tomar fotografias de paisajes impresionantes es mi parte favorita de MASK viaje largo, cada
tomar fotografias de paisajes impresionantes es mi parte favorita de cada MASK largo, viaje
tomar fotografias de paisajes impresionantes es mi parte favorita de cada viaje MASK, largo
MASK por las calles de una ciudad desconocida puede ser una aventura emocionante, perderse
perderse MASK las calles de una ciudad desconocida puede ser una aventura emocionante, por
perderse por MASK calles de una ciudad desconocida puede ser una aventura emocionante, las
perderse por las MASK de una ciudad desconocida puede ser una aventura emocionante, calles
perderse por las calles MASK una ciudad desconocida puede ser una aventura emocionante, de
perderse por las calles de MASK ciudad desconocida puede ser una aventura emocionante, una
perderse por las calles de una MASK desconocida puede ser una aventura emocionante, ciudad
perderse por las calles de una ciudad MASK puede ser una aventura emocionante, desconocida
perderse por las calles de una ciudad desconocida MASK ser una aventura emocionante, puede
perderse por las calles de una ciudad desconocida puede MASK una aventura emocionante, ser
perderse por las calles de una ciudad desconocida puede ser MASK aventura emocionante, una
perderse por las calles de una ciudad desconocida puede ser una MASK emocionante, aventura
perderse por las calles de una ciudad desconocida puede ser una aventura MASK, emocionante
MASK museo de arte moderno exhibe obras de artistas contemporaneos muy reconocidos internacionalmente, el
el MASK de arte moderno exhibe obras de artistas contemporaneos muy reconocidos internacionalmente, museo
el museo MASK arte moderno exhibe obras de artistas contemporaneos muy reconocidos internacionalmente, de
el museo de MASK moderno exhibe obras de artistas contemporaneos muy reconocidos internacionalmente, arte
el museo de arte MASK exhibe obras de artistas contemporaneos muy reconocidos internacionalmente, moderno
el museo de arte moderno MASK obras de artistas contemporaneos muy reconocidos internacionalmente, exhibe
el museo de arte moderno exhibe MASK de artistas contemporaneos muy reconocidos internacionalmente, obras
el museo de arte moderno exhibe obras MASK artistas contemporaneos muy reconocidos internacionalmente, de
el museo de arte moderno exhibe obras de MASK contemporaneos muy reconocidos internacionalmente, artistas
el museo de arte moderno exhibe obras de artistas MASK muy reconocidos internacionalmente, contemporaneos
el museo de arte moderno exhibe obras de artistas contemporaneos MASK reconocidos internacionalmente, muy
el museo de arte moderno exhibe obras de artistas contemporaneos muy MASK internacionalmente, reconocidos
el museo de arte moderno exhibe obras de artistas contemporaneos muy reconocidos MASK, internacionalmente
MASK a un concierto de musica clasica en el auditorio nacional anoche mismo, asistimos
asistimos MASK un concierto de musica clasica en el auditorio nacional anoche mismo, a
asistimos a MASK concierto de musica clasica en el auditorio nacional anoche mismo, un
asistimos a un MASK de musica clasica en el auditorio nacional anoche mismo, concierto
asistimos a un concierto MASK musica clasica en el auditorio nacional anoche mismo, de
asistimos a un concierto de MASK clasica en el auditorio nacional anoche mismo, musica
asistimos a un concierto de musica MASK en el auditorio nacional anoche mismo, clasica
asistimos a un concierto de musica clasica MASK el auditorio nacional anoche mismo, en
asistimos a un concierto de musica clasica en MASK auditorio nacional anoche mismo, el
asistimos a un concierto de musica clasica en el MASK nacional anoche mismo, auditorio
asistimos a un concierto de musica clasica en el auditorio MASK anoche mismo, nacional
asistimos a un concierto de musica clasica en el auditorio nacional MASK mismo, anoche
asistimos a un concierto de musica clasica en el auditorio nacional anoche MASK, mismo
MASK novela historica que estoy leyendo ahora mismo esta ambientada en la francia, la
la MASK historica que estoy leyendo ahora mismo esta ambientada en la francia, novela
la novela MASK que estoy leyendo ahora mismo esta ambientada en la francia, historica
la novela historica MASK estoy leyendo ahora mismo esta ambientada en la francia, que
la novela historica que MASK leyendo ahora mismo esta ambientada en la francia, estoy
la novela historica que estoy MASK ahora mismo esta ambientada en la francia, leyendo
la novela historica que estoy leyendo MASK mismo esta ambientada en la francia, ahora
la novela historica que estoy leyendo ahora MASK esta ambientada en la francia, mismo
la novela historica que estoy leyendo ahora mismo MASK ambientada en la francia, esta
la novela historica que estoy leyendo ahora mismo esta MASK en la francia, ambientada
la novela historica que estoy leyendo ahora mismo esta ambientada MASK la francia, en
la novela historica que estoy leyendo ahora mismo esta ambientada en MASK francia, la
la novela historica que estoy leyendo ahora mismo esta ambientada en la MASK, francia
MASK festival de cine internacional presenta peliculas de diversos generos y nacionalidades diferentes, el
el MASK de cine internacional presenta peliculas de diversos generos y nacionalidades diferentes, festival
el festival MASK cine internacional presenta peliculas de diversos generos y nacionalidades diferentes, de
el festival de MASK internacional presenta peliculas de diversos generos y nacionalidades diferentes, cine
el festival de cine MASK presenta peliculas de diversos generos y nacionalidades diferentes, internacional
el festival de cine internacional MASK peliculas de diversos generos y nacionalidades diferentes, presenta
el festival de cine internacional presenta MASK de diversos generos y nacionalidades diferentes, peliculas
el festival de cine internacional presenta peliculas MASK diversos generos y nacionalidades diferentes, de
el festival de cine internacional presenta peliculas de MASK generos y nacionalidades diferentes, diversos
el festival de cine internacional presenta peliculas de diversos MASK y nacionalidades diferentes, generos
el festival de cine internacional presenta peliculas de diversos generos MASK nacionalidades diferentes, y
el festival de cine internacional presenta peliculas de diversos generos y MASK diferentes, nacionalidades
el festival de cine internacional presenta peliculas de diversos generos y nacionalidades MASK, diferentes
MASK exposicion de fotografia documental muestra realidades sociales de todo el gran mundo, la
la MASK de fotografia documental muestra realidades sociales de todo el gran mundo, exposicion
la exposicion MASK fotografia documental muestra realidades sociales de todo el gran mundo, de
la exposicion de MASK documental muestra realidades sociales de todo el gran mundo, fotografia
la exposicion de fotografia MASK muestra realidades sociales de todo el gran mundo, documental
la exposicion de fotografia documental MASK realidades sociales de todo el gran mundo, muestra
la exposicion de fotografia documental muestra MASK sociales de todo el gran mundo, realidades
la exposicion de fotografia documental muestra realidades MASK de todo el gran mundo, sociales
la exposicion de fotografia documental muestra realidades sociales MASK todo el gran mundo, de
la exposicion de fotografia documental muestra realidades sociales de MASK el gran mundo, todo
la exposicion de fotografia documental muestra realidades sociales de todo MASK gran mundo, el
la exposicion de fotografia documental muestra realidades sociales de todo el MASK mundo, gran
la exposicion de fotografia documental muestra realidades sociales de todo el gran MASK, mundo
MASK a bailar salsa es una actividad divertida y socialmente muy enriquecedora tambien, aprender
aprender MASK bailar salsa es una actividad divertida y socialmente muy enriquecedora tambien, a
aprender a MASK salsa es una actividad divertida y socialmente muy enriquecedora tambien, bailar
aprender a bailar MASK es una actividad divertida y socialmente muy enriquecedora tambien, salsa
aprender a bailar salsa MASK una actividad divertida y socialmente muy enriquecedora tambien, es
aprender a bailar salsa es MASK actividad divertida y socialmente muy enriquecedora tambien, una
aprender a bailar salsa es una MASK divertida y socialmente muy enriquecedora tambien, actividad
aprender a bailar salsa es una actividad MASK y socialmente muy enriquecedora tambien, divertida
aprender a bailar salsa es una actividad divertida MASK socialmente muy enriquecedora tambien, y
aprender a bailar salsa es una actividad divertida y MASK muy enriquecedora tambien, socialmente
aprender a bailar salsa es una actividad divertida y socialmente MASK enriquecedora tambien, muy
aprender a bailar salsa es una actividad divertida y socialmente muy MASK tambien, enriquecedora
aprender a bailar salsa es una actividad divertida y socialmente muy enriquecedora MASK, tambien
MASK opera es un espectaculo impresionante que combina musica teatro y tambien escenografia, la
la MASK es un espectaculo impresionante que combina musica teatro y tambien escenografia, opera
la opera MASK un espectaculo impresionante que combina musica teatro y tambien escenografia, es
la opera es MASK espectaculo impresionante que combina musica teatro y tambien escenografia, un
la opera es un MASK impresionante que combina musica teatro y tambien escenografia, espectaculo
la opera es un espectaculo MASK que combina musica teatro y tambien escenografia, impresionante
la opera es un espectaculo impresionante MASK combina musica teatro y tambien escenografia, que
la opera es un espectaculo impresionante que MASK musica teatro y tambien escenografia, combina
la opera es un espectaculo impresionante que combina MASK teatro y tambien escenografia, musica
la opera es un espectaculo impresionante que combina musica MASK y tambien escenografia, teatro
la opera es un espectaculo impresionante que combina musica teatro MASK tambien escenografia, y
la opera es un espectaculo impresionante que combina musica teatro y MASK escenografia, tambien
la opera es un espectaculo impresionante que combina musica teatro y tambien MASK, escenografia
MASK galerias de arte pequenas permite descubrir nuevos talentos artisticos y locales, visitar
visitar MASK de arte pequenas permite descubrir nuevos talentos artisticos y locales, galerias
visitar galerias MASK arte pequenas permite descubrir nuevos talentos artisticos y locales, de
visitar galerias de MASK pequenas permite descubrir nuevos talentos artisticos y locales, arte
visitar galerias de arte MASK permite descubrir nuevos talentos artisticos y locales, pequenas
visitar galerias de arte pequenas MASK descubrir nuevos talentos artisticos y locales, permite
visitar galerias de arte pequenas permite MASK nuevos talentos artisticos y locales, descubrir
visitar galerias de arte pequenas permite descubrir MASK talentos artisticos y locales, nuevos
visitar galerias de arte pequenas permite descubrir nuevos MASK artisticos y locales, talentos
visitar galerias de arte pequenas permite descubrir nuevos talentos MASK y locales, artisticos
visitar galerias de arte pequenas permite descubrir nuevos talentos artisticos MASK locales, y
visitar galerias de arte pequenas permite descubrir nuevos talentos artisticos y MASK, locales
MASK literatura clasica ofrece profundas reflexiones sobre la condicion humana a traves tiempo, la
la MASK clasica ofrece profundas reflexiones sobre la condicion humana a traves tiempo, literatura
la literatura MASK ofrece profundas reflexiones sobre la condicion humana a traves tiempo, clasica
la literatura clasica MASK profundas reflexiones sobre la condicion humana a traves tiempo, ofrece
la literatura clasica ofrece MASK reflexiones sobre la condicion humana a traves tiempo, profundas
la literatura clasica ofrece profundas MASK sobre la condicion humana a traves tiempo, reflexiones
la literatura clasica ofrece profundas reflexiones MASK la condicion humana a traves tiempo, sobre
la literatura clasica ofrece profundas reflexiones sobre MASK condicion humana a traves tiempo, la
la literatura clasica ofrece profundas reflexiones sobre la MASK humana a traves tiempo, condicion
la literatura clasica ofrece profundas reflexiones sobre la condicion MASK a traves tiempo, humana
la literatura clasica ofrece profundas reflexiones sobre la condicion humana MASK traves tiempo, a
la literatura clasica ofrece profundas reflexiones sobre la condicion humana a MASK tiempo, traves
la literatura clasica ofrece profundas reflexiones sobre la condicion humana a traves MASK, tiempo
MASK grupo de musica folklorica ofrecio un recital gratuito en la plaza mayor, el
el MASK de musica folklorica ofrecio un recital gratuito en la plaza mayor, grupo
el grupo MASK musica folklorica ofrecio un recital gratuito en la plaza mayor, de
el grupo de MASK folklorica ofrecio un recital gratuito en la plaza mayor, musica
el grupo de musica MASK ofrecio un recital gratuito en la plaza mayor, folklorica
el grupo de musica folklorica MASK un recital gratuito en la plaza mayor, ofrecio
el grupo de musica folklorica ofrecio MASK recital gratuito en la plaza mayor, un
el grupo de musica folklorica ofrecio un MASK gratuito en la plaza mayor, recital
el grupo de musica folklorica ofrecio un recital MASK en la plaza mayor, gratuito
el grupo de musica folklorica ofrecio un recital gratuito MASK la plaza mayor, en
el grupo de musica folklorica ofrecio un recital gratuito en MASK plaza mayor, la
el grupo de musica folklorica ofrecio un recital gratuito en la MASK mayor, plaza
el grupo de musica folklorica ofrecio un recital gratuito en la plaza MASK, mayor
