como qualquer adolescente , so quer que gostem dela e ser aceite .	and like any teenager , she just wants to be liked and to fit in .
e nem o gana o tinha feito , ainda que estivessemos a tentar arduamente .	i mean , nor had ghana , even though we had been trying very hard .
o memorial abriu em 2011 , e o museu abre no proximo ano , em 2014 .	so the memorial opened in 2011 , and the museum 's going to open next year in 2014 .
( aplausos )	( applause )
entao agora o que posso fazer e , mais do que obter instrucoes para o dispositivo online , eu posso simplesmente apontar para ele , o dispositivo e reconhecido , e entao — voz : comece por ligar o cabo adsl cinza .	so now what i can do is , rather than getting the instructions for the device online , i can simply point at it , the device is recognized , and then — voice : begin by plugging in the grey adsl cable .
o primeiro jornal independente da eslovaquia .	first independent newspaper in slovakia .
penso que a marca de uma grande empresa e mostrar abertura aos desafios , e a marca de uma boa administracao e desafiar de forma construtiva .	i think the mark of a great company is being open to be challenged , and the mark of a good corporate board is to constructively challenge .
e em nenhuma outra ocasiao nos apercebemos mais disso do que durante o furacao sandy . o furacao sandy foi uma super tempestade como nao se via ha muito tempo que atingiu a capital universal do iphone ... ( risos ) e tivemos uma quantidade de noticias nunca antes vista .	and nowhere was this brought home more than during hurricane sandy . so what you had in hurricane sandy was a superstorm , the likes of which we had n't seen for a long time , hitting the iphone capital of the universe — ( laughter ) — and you got volumes of media like we 'd never seen before .
quem e o responsavel por este processo ?	who is accountable for this process ?
ele ... a sua namorada estava gravida quando ele foi para tribunal , certo ? e ela teve um pequeno bebe , um menino .	he — his girlfriend was pregnant when he went to trial , right ? and she had a little baby boy .
no total , encontrei 185 produtos .	in total , i found 185 products .
na verdade , esse e o quadro de previsao .	in fact , this is the forecast picture .
ira durar muito , muito tempo .	it will last for a long , long time .
as instituicoes governamentais foram completamente destruidas , incluindo o palacio presidencial .	government institutions were completely decapitated , including the presidential palace .
se se prolongar por mais do que um segundo , e suficiente para , basicamente , destruir as proteinas das celulas .	if you do it for more than a second , it 's enough to basically destroy the proteins of the cells .
somos as unicas criaturas com sentimentos morais completamente desenvolvidos .	we 're the only creatures with fully developed moral sentiments .
creio que o pior insulto , a pior ofensa , que se pode fazer a um mexicano e insultar a sua mae .	i think the biggest insult , the worst way you can offend a mexican is to insult their mother .
nascemos para elas .	we 're born for them .
bem as escritas linguisticas realmente codificam multiplas linguas .	well linguistic scripts can actually encode multiple languages .
eu tenho um irmao , o gavin .	so i have a brother , gavin .
portanto , e uma boa licao para nos .	so it 's a good lesson for us .
e antes mesmo de ter decidido fazer da narrativa de historias a minha profissao , consigo ver agora acontecimentos-chave na minha juventude que , de certo modo , abriram de facto os meus olhos para certas coisas acerca das historias .	and before i 'd even decided to make storytelling my career , i can now see key things that happened in my youth that really sort of opened my eyes to certain things about story .
quando o casamento era um empreendimento economico , a infidelidade ameacava a nossa seguranca economica .	when marriage was an economic enterprise , infidelity threatened our economic security .
e , na verdade , a melhora .	it actually improves it .
estavamos num dos paises mais pobres do planeta , mas 80 por cento das pessoas tinha telemoveis nas suas maos .	we were in one of the poorest countries on the planet , but 80 percent of the people had mobile devices in their hands .
e mesmo que sejam cegos , podem por a mao sobre ela , e ver as faixas da estrada e obstaculos .	so even though you are blind , you can put your hand over it , you can see the lanes of the road and obstacles .
de facto , as pessoas tem-me dito que agora vao gostar de ser picadas pelos mosquitos .	in fact , people have told me that now they will enjoy being bitten by mosquitos .
mais uma coisa .	one more thing .
eu aprendi imensa coisa sobre mim mesma .	i learned so much about myself .
e elas pararam .	and they did .
entao podem investir o mesmo carinho , a mesma tecnica , num hamburguer como investiriam num prato muito mais pomposo .	so you can lavish all the same care , all the same technique , on a hamburger as you would on some much more fancy dish .
o que se passa cada vez mais , e que estes sistemas tem comecado a usar internet .	what 's happening increasingly , though , is these systems are beginning to use the internet .
nao estou a sugerir que nos tenhamos que ser sexualmente fieis aos nossos parceiros .	i 'm not suggesting that we 're not — that we 're necessarily sexually faithful to our partners .
( risos ) para muitas pessoas , isto e uma loucura .	( laughter ) to many people , this seems crazy .
e naquele dia , por acaso , gostei de uma sobre as vantagens da literacia musical nas escolas e partilhei-a numa rede social .	and in this particular case i happened to like one of them on the merits of music literacy in schools and i shared it over a social network .
eu ja . procuro-a sempre .	i do . i look for it all the time .
a segunda ronda de votos tambem nao apurou um vencedor claro .	now the second round of voting did not bring forth a clear winner either .
a tecnologia da informacao cresce de forma exponencial .	information technology grows in an exponential manner .
deixou de sentir-se impotente e apercebeu-se do que era capaz de apoiar a filha , com o apoio de outras pessoas	she went from feeling helpless to realizing how capable she was of supporting her daughter , with the support of other people who were going through the same struggle .
eu vi coisas bem feias .	we saw some very ugly things .
2 % nao e 20 % mas , no negocio dos carros , que e muito lento a mudar , isso e enorme , e uma chegada .	two percent is n't 20 percent , but in the car business , which is slow moving , that 's huge ; that 's arrival .
captar e correlacionar os rastos de informacao que deixamos nos mais diversos sitios e um desafio enorme , mas que nos estao a pedir para realizar .	now , capturing and correlating the trails of information that we leave in different places is a massive challenge , but one we 're being asked to figure out .
portanto , nao nos podemos dar por satisfeitos , nem de longe .	so we ca n't be satisfied , not even close to satisfied .
no inicio e muito uniforme .	at the beginning it 's very uniform .
jeff norris : ola , alex .	jeff norris : hey , alex .
vamos chegar la rapidamente ?	are we going to be there soon ?
`` a vossa resposta ao `` '' stress '' '' quer ter a certeza de que voces reparam quando alguem na vossa vida esta a passar por uma situacao dificil para que se possam apoiar mutuamente . ''	your stress response wants to make sure you notice when someone else in your life is struggling so that you can support each other .
nos podemos descodificar o genoma , podemos olhar para tras e ligar-nos a todos pelo adn mitocondrial , mas , nao conseguimos ir alem do ultimo ancestral , a ultima celula visivel que poderiamos sequenciar ou pensar atras na historia .	you can decode the genome , you can look back , you can link us all together by a mitochondrial dna , but we ca n't get further than the last ancestor , the last visible cell that we could sequence or think back in history .
porque eu penso que todos irao concordar que o unico proposito legitimo do governo e servir os cidadaos . e eu argumentaria que o unico proposito legitimo da tecnologia e melhorar as nossas vidas , nao para nos manipular e escravizar .	because i think all of you will agree that the only legitimate purpose of government is to serve citizens , and i would argue that the only legitimate purpose of technology is to improve our lives , not to manipulate or enslave us .
sao 600 mil milhoes de dolares por ano e esta a aumentar , e estas pessoas estao a ser exploradas .	this is 600 billion dollars a year , and it 's growing , and these people are getting ripped off .
estamos no ano 1960 .	the year is 1960 .
por outras palavras , o petroleo esta a deixar de ser competitivo mesmo com precos baixos , antes de se tornar escasso , mesmo com os precos altos .	in other words , oil is getting uncompetitive even at low prices before it becomes unavailable even at high prices .
embora muita gente me tentasse confortar e encorajar , as suas palavras soavam a barulho sem sentido .	although many people tried to comfort and encourage me , their words sounded like meaningless noise .
por exemplo , o numero 164 destaca-se bastante no codigo ; nao se pode desprezar .	so for example , the number 164 really stands out in that code ; you ca n't overlook it .
e o livro todo .	it 's the whole book .
estavamos errados entao , e estamos errados novamente .	we were wrong then , and we are wrong again .
de facto , a nossa sociedade de consumo e largamente baseada no capital de seducao .	indeed , our consumer society is largely based on seduction capital .
mas nao e uma tarefa facil .	but it is not an easy task .
eu nao tenho nenhuma relacao com os eua , com nenhum do seus 50 estados .	i have no relationship with the united states , all 50 of them , not really .
muito obrigada .	thank you very much .
( aplausos )	( applause )
congelamos metade do cerebro . ele regenera .	you can freeze half the brain . it regrows .
entao testei isto com criancas autistas , e descobri que havia uma quantidade incrivel de identificacao .	so i tried this out with kids with autism , and i found that there was an incredible amount of identification .
`` entao , estes colegas dizem : `` '' nos podemos , sim , `` '' recuperar as outras areas , `` '' inclusive desertos '' '' . ''	these colleagues propose that , yes , we can save other areas , including deserts .
e e muito simples , como podem ver aqui .	and it 's really simple , as you can see here .
o problema era que um grupo influente em oxford comecou a defender que , por ter funcionado tao bem na economia , este metodo dedutivo devia ser aplicado as ciencias naturais tambem .	the problem was that an influential group at oxford began arguing that because it worked so well in economics , this deductive method ought to be applied to the natural sciences too .
isto e determinado em grande escala pelo tempo de repercussao , quao repercussiva e uma sala .	this is affected massively by reverberation time , how reverberant a room is .
temos oportunidades na agricultura , como ja disse .	we have opportunities in agriculture , like i said .
com a resposta instantanea , o computador classifica os exercicios .	with instant feedback , the computer grades exercises .
ele desmontou o manuscrito de arquimedes e os outros sete manuscritos ,	he took apart the archimedes manuscript and the other seven manuscripts .
pedacos de pedra chegaram a terra .	pieces of rocks landed on the earth .
sabiam que nos americanos ocupamos cerca de tres vezes mais espaco do que ocupavamos ha 50 anos ?	did you know that we americans have about three times the amount of space we did 50 years ago ?
houve um filme sobre ele , feito recentemente .	there was sort of a movie made about it recently .
mas olhemos para alem dos meus olhos .	but let 's take a look behind my eyes .
estamos interessados em mais do que isso .	we 're interested in more than that .
e quando falamos de internet , sim , e verdade , a internet ligou-nos a todos , mas tambem sabemos que a internet criou camaras de ressonancia e guetos politicos que nos permitem ficar na comunidade politica a que pertencemos toda a vida .	and when we talk about the internet , yes , it 's true , the internet connected all of us , but we also know that the internet created these echo chambers and political ghettos in which for all your life you can stay with the political community you belong to .
o mais importante que temos de ter em mente e que a reputacao e contextual .	but the most important thing that we have to keep in mind is that reputation is largely contextual .
as possibilidades que as novas tecnologias digitais estao a trazer podem ajudar organizacoes humanitarias , nao apenas assegurar que o direito das pessoas a informacao e cumprido , ou que eles tem o direito de comunicar , mas penso que no futuro , as organizacoes humanitarias vao ter de antecipar o direito das pessoas ao acesso a tecnologias criticas de comunicacao para assegurar que as suas vozes sao ouvidas , que estao verdadeiramente a participar , que sao verdadeiramente mais poderosas no mundo humanitario .	the possibilities that new digital technologies are bringing can help humanitarian organizations , not only ensure that people 's right to information is met , or that they have their right to communicate , but i think in the future , humanitarian organizations will also have to anticipate the right for people to access critical communication technologies in order to ensure that their voices are heard , that they 're truly participating , that they 're truly empowered in the humanitarian world .
de volta a minha pergunta : porque e que fiquei ?	back to my question : why did i stay ?
muitas destas cidades estao a crescer incrivelmente depressa .	most of those cites are growing incredibly quickly .
nao podiamos resolver este problema com 50 % da populacao a assistir nas bancadas .	we could n't solve this problem with 50 percent of the population on the sidelines .
e a sua assinatura ?	is that your signature ?
nos servimos juntos no iraque e no afeganistao .	we served together in iraq and afghanistan .
os medicos e os enfermeiros tambem recebem formacao .	now , doctors and nurses — they too get trained .
e triste porque aquelas pessoas que eu descrevi , estavam muito desinteressadas do processo de aprendizagem , queriam ser professores eficientes , mas nao tinham modelos .	it 's sad because the people who i described , they were very disinterested in the learning process , want to be effective teachers , but they have no models .
`` `` '' em 20 de junho '' '' , se conseguem ler , `` 2011 . '' ''	`` `` '' on june 20th , '' '' if you can read it , `` 2011 . '' ''
nada foi feito a esta imagem .	there 's nothing done to this image .
( aplausos )	( applause )
e falamos de coisas mesmo pequenas .	and we 're talking really small here .
a tinta condutora tem sido usada por artistas , mas descobertas recentes indicam que em breve poderemos usa-la em impressoras a laser e canetas .	conductive ink has been used by artists , but recent developments indicate that we will soon be able to use it in laser printers and pens .
ora aqui esta algo sobre o envelhecimento que e um pouco universal .	so there 's something about aging that 's kind of universal .
o tipo de objectivo que queremos alcancar e que sejam digitalizados 450 livros por dia .	the type of objective we want to reach is 450 books a day that can be digitized .
`` `` '' o emblema vermelho do michael parecia que podia voar . ''	the red emblem of michael looked as if it could fly .
voz 15 : liguei a televisao .	voice 15 : so i switched on the television .
mas ha umas caracteristicas isabelinas idiossincraticas no vosso comportamento , ou jorgianas , que nos fazem compreender-vos melhor que uma molhada de tracos ,	but are there some distinctively elizabethan features of your behavior , or georgian of yours , that make us understand you better than just a bunch of traits ?
tao ambicioso como nos somos .	that 's as ambitious as we are .
se nos impedir de reparar nos problemas a nossa volta , isso e mau .	if it stops us from noticing the problems that are around us , well , that 's bad .
e mais uma vez , ele voluntariou-se para um estudo essencial que fizemos em todo o mundo , incluindo os e.u.a .	and again , he volunteered to a pivotal study that we ran worldwide , also in the u.s .
fg : porque eu quero ter uma ovacao de pe como todos os outros , portanto ...	fg : because i want to get a standing ovation like everybody , so ...
mas ha mais coisas que podemos fazer com estas caixas magicas .	but there 's more than you can do with these magic boxes .
deixem-me dizer-vos , este foi um modo estranho de barbear , porque eu pensei acerca disso e apercebi-me que a forma como me estava a barbear seria a forma como me iria barbear o resto da vida — porque eu tinha de manter o tamanho de pelo igual .	let me tell you , this was a strange way to shave , because i thought about it and i realized that the way i was shaving then would be the way i would shave for the rest of my life — because i had to keep the width the same .
mas isto nao significa que nao possamos dar uma resposta ponderada .	but this does n't mean we still ca n't give them a considered response .
a stasi era a policia secreta na republica democratica alema .	stasi was the secret police in east germany .
habituei-me com seu comportamento disfuncional .	i 've become very familiar with its dysfunctional behavior .
podemos ver as variacoes de densidade disto .	and we can see the density variations of this .
tinha uma faceta seria .	there was actually a serious note to it .
e isto tambem se aplica a nodulos linfaticos com metastases .	and this works for metastatic lymph nodes also .
e uns amigos meus e eu decidimos que isto nao fazia sentido .	and a few friends of mine and i decided this does n't make sense .
tambem e o nosso pais .	it 's our country , too .
terceira licao : usar dados para sustentar os argumentos .	third lesson : use data to drive your argument .
e o que acontece quando nos tornamos curiosos ?	and what happens when we get curious ?
`` eu interrogo-me quao frequente sao raptos de bebes dos hospitais . '' '' eu chego a casa , e procuro . ''	`` i wonder how rampant baby snatching is out of hospitals . '' '' i go home , i look it up . ''
porque e que o faco ?	so , why do i do what i do ?
( aplausos )	( applause )
e aqui esta uma das minhas pinturas .	and here is one of my paintings .
talvez eu possa ser um cineasta .	maybe i could become a filmmaker .
michael shermer : muitissimo obrigado . obrigado a todos . obrigado .	michael shermer : thank you very much . thank you . thanks .
e , tambem penso que e importante perceber que estas conversas ja duram ha algum tempo .	and i also think it 's important to realize that the conversation 's been going on for a while , by the way .
se os usarmos bem , podemos viver mais saudaveis e de modo mais belo .	and if we use them well , we can live healthier and more beautifully .
movimentos sao sobre momentos , e nos aproveitamos este momento .	movements are about moments , and we seized this moment .
eu estava la para cobrir o aniversario de 25 anos do pior acidente nuclear do mundo , como voces podem ver pelo meu olhar , eu estava relutante , e com razao , porque o fogo nuclear que ardeu durante 11 dias , em 1986 , libertou 400 vezes mais radiacao do que a bomba de hiroshima e o sarcofago , que e a cobertura sobre o reator numero quatro , que foi apressadamente construido ha 27 anos , esta rachado , enferrujado e com fugas de radiacao .	i was there covering the 25th anniversary of the world 's worst nuclear accident , as you can see by the look on my face , reluctantly so , but with good reason , because the nuclear fire that burned for 11 days back in 1986 released 400 times as much radiation as the bomb dropped on hiroshima , and the sarcophagus , which is the covering over reactor number four , which was hastily built 27 years ago , now sits cracked and rusted and leaking radiation .
efectivamente , tudo o que vou dizer a partir de agora e basicamente comparar estas familias quase identicas .	now effectively everything i 'm going to tell you from now on is only comparing these basically nearly identical families .
isto foi nos anos 90 durante o pico da epidemia de vih , antes de existirem farmacos anti-retrovirais ( arvs ) na africa subsariana .	this was in the 90s during the peak of the hiv epidemic , before there were any arvs in sub-saharan africa .
os meus amigos do twitter nao abandonaram as suas crencas ou os seus principios , apenas o seu desprezo .	my friends on twitter did n't abandon their beliefs or their principles — only their scorn .
mesmo depois deste nivel granular de controlo , e verdade que os falantes de linguas sem futuro parecem poupar mais ?	now even after all of this granular level of control , do futureless language speakers seem to save more ?
( aplausos ) ok , henry , voce tem ido a washington ultimamente ?	( applause ) okay , henry , have you been to d.c. lately ?
a resposta e fazer com que os carros venham daquele lado com seguranca .	the answer is to enable cars to come in from that side road safely .
a constituicao dos eua precisa das mulheres .	the us constitution needs women .
quando eu acabar de falar aqui , vai haver mais 864 horas de video no youtube do que quando comecei , e mais dois milhares e meio de fotos no facebook e no instagram do que quando comecei .	so by the time i 'm finished talking here , there 'll be 864 more hours of video on youtube than there were when i started , and two and a half million more photos on facebook and instagram than when i started .
foi cacado ate restarem apenas alguns que morreram em jardins zoologicos .	it was hunted until there were just a few left to die in zoos .
( aplausos )	( applause )
mas o petroleo e substituido pela bateria .	but the crude oil is replaced with a battery .
mas ainda ha meio biliao de dolares a poupar na industria como um todo .	but industry as a whole has another half-trillion dollars of energy still to save .
`` ( risos ) ao que ela respondeu : `` '' bem , sera sobre si . '' '' quero dizer , e de uma humildade incrivel . ( risos ) ''	`` ( laughter ) and she was like , `` '' well , it 'll be about you . '' '' i mean , that 's just incredible humility . ( laughter ) ''
nao e obvio o que se passa exactamente .	it 's not obvious exactly what 's going on .
eu podia conhecer a ideia de cantor de que alguns conjuntos infinitos sao maiores que outros , mas eu nao entendia o calculo por detras desta ideia .	i might know , you know , cantor 's idea that some infinite sets are larger than other infinite sets , but i did n't really understand the calculus behind that idea .
nos , todos nos , somos o que acontece quando uma mistura primordial de hidrogenio e helio evolui durante tanto tempo que comeca a questionar de onde vem .	we , all of us , are what happens when a primordial mixture of hydrogen and helium evolves for so long that it begins to ask where it came from .
agora , o mesmo mantem-se para tratamentos baseados em treino .	now , the same holds for training-based treatments .
e voces so tem que seguir estas simples , simples regras : se local , deixa o meio ambiente liderar e pensa como os nossos netos poderao construir .	and you just have to follow these simple , simple rules : be local , let the environment lead and think about how your grandchildren might build .
esta inutilidade e facilmente demonstrada , porque , de forma a ser valorizado , preciso que outro me deseje , o que demonstra que nao tenho qualquer valor so por mim proprio .	this uselessness is easily demonstrated , because in order to be valued i need another to desire me , which shows that i do not have any value of my own .
`` e voces poderiam dizer , quando entendessem a resposta a isso , `` '' bem , eu confio em alguns , mas nao em todos '' '' . ''	`` and you might say , when you understood the answer to that , `` well , i trust some of them , but not others . '' ''
nesse sentido , se definirmos nossos interesses , por exemplo , para os eua do jeito que a gra-bretanha definiu os seus no seculo xix , mantendo um sistema de comercio aberto , uma estabilidade monetaria , liberdade dos mares — essas coisas foram boas para a gra-bretanha , e foram boas para os outros tambem .	in that sense , if we define our interests , for example , for the united states the way britain defined its interests in the 19th century , keeping an open trading system , keeping a monetary stability , keeping freedom of the seas — those were good for britain , they were good for others as well .
`` e funcionou lindamente , fazendo grande sensacao nas noticias , incluindo o pinaculo do sucesso cientifico : uma publicacao na revista `` '' nature '' '' . funcionou optimamente , ano apos ano apos ano , ate que um dia falhou . ''	`` and it worked beautifully , and it made a big splash in the news , including the pinnacle of scientific success : a publication in the journal `` '' nature . '' '' it worked beautifully for year after year after year , until one year it failed . ''
quando os medicos viram este efeito de melhoria de humor da iproniazida , de inicio nao entenderam realmente o que estavam a ver .	when doctors first saw this mood-enhancing effect of iproniazid , they did n't really recognize what they saw .
e se fosse como uma conversa , por turnos , a ouvir e a falar , tal como fazemos na vida ?	what if it could be like a conversation , taking turns listening and speaking , just like we do in life ?
tenho estado em prisoes , infiltrado .	i have been undercover in the prisons .
o que escolheriam ?	what would you choose ?
sempre senti no meu amago que isto estava errado e que os introvertidos eram excelentes como eram .	and i always sensed deep down that this was wrong and that introverts were pretty excellent just as they were .
queria vir para casa e fazer uma pausa e talvez comecar de novo .	and i wanted to come home and take a break and maybe start over .
e o que temos de tentar , por fim .	and ultimately , we have to try that .
ja nao era uma crianca , mas uma jovem adolescente .	no longer a child , but a young woman .
mas toda aquela crenca tinha-me dado forca durante tanto tempo .	but all that belief had fueled me so long .
felizmente , temos uma metafora muito util : a interface do ambiente de trabalho do computador .	well , fortunately , we have a very helpful metaphor : the desktop interface on your computer .
mas ha um problema fundamental que esta a destruir os esforcos usados para combater esta doenca , porque se continuarmos apenas a dar medicamentos as pessoas que nao tem servicos de diagnostico , acaba-se por criar um problema de resistencia aos farmacos .	but there is a fundamental problem that is killing the efforts in fighting this disease , because if you keep throwing drugs out at people who do n't have diagnostic services , you end up creating a problem of drug resistance .
agora imaginem que as mulheres estao representadas aqui e os homens estao representados aqui .	now imagine that women are represented here , and men are represented here .
o james tal como voces e eu , e mais do que a pior coisa que ja fez .	now james , like you and me , is more than the worst thing he 's done .
maos no ar .	hands up .
fazer uma cronica da vida , ano apos ano vulneravel seria agarrar-se ao que era efemero , seria dar a mim mesmo e aos outros um vislumbre do futuro , independemente de la chegarmos ou nao .	to chronicle a life year by vulnerable year would be to clasp and to ground what was fleeting , would be to provide myself and others a glimpse into the future , whether we made it there or not .
isto e incrivel para mim , e por vezes quando estou nervosa , preciso de dizer algumas afirmacoes que me possam ajudar , tipo ...	that 's incredible to me , and sometimes when i 'm nervous and everything like that , i just need to , like , say some affirmations that can help me .
conseguimos recrutar em massa a baixo custo para ensaios clinicos e conseguimos fazer rastreios a uma escala populacional viavel para esta primeira fase .	we can perform low-cost mass recruitment for clinical trials , and we can make population-scale screening feasible for the first time .
e a quantidade exacta de danos que estas empresas de media sofrem sempre que uma musica ou filme e pirateado .	it 's the precise amount of harm that comes to media companies whenever a single copyrighted song or movie gets pirated .
precisamos de dados , nao precisamos de ajuda .	we need data , we do n't need help .
o valor acrescentado das nossas manufaturas e de apenas 11 % .	our manufacturing value-added is only 11 percent .
se quem tu queres ser , nao quem eles querem que sejas .	be who you to want to be , not who they want you to be .
isso e deslocamento do espaco .	that 's displacement of space .
voces ! voces estao a impor isto !	you ! you are imposing this on me !
o zumbido nao e poder nem e apenas trabalho .	the hum is not power and the hum is not work-specific .
e um grande recipiente cheio de pequenas bombas .	it 's a large canister filled with bomblets .
quantos de voces sabem fazer pao ? assim , como eu estou a fazer , sem uma maquina de fazer pao ou sem qualquer tipo de farinha instantanea ?	how many of you actually can make a bread in this way , without starting with a bread machine or just some kind of packaged flavor ?
e verdade , ha coisas como o grameen bank e os microemprestimos .	and , yes , there are things like grameen bank and micro-lending .
entao estao a afastar-se cada vez mais .	so they 're moving further apart .
e acabei por ter uma ideia .	and i came up with an idea .
nenhuma delas foi perfeita , nem sera , mas a tendencia e muito clara .	not all of them have been perfect , or will be , but the trend is very clear .
tiraram duas das minhas costelas partidas , e reconstruiram a minha medula , l1 , reconstruiram-na , e tiraram outra costela partida , e fundiram a t12 , l1 e l2 .	they took out two of my broken ribs , and they rebuilt my back , l1 , they rebuilt it , they took out another broken rib , they fused t12 , l1 and l2 together .
se fosse para mim , os meus pais diriam que eu nao estava em casa .	if it was for me , my parents would say i 'm not around .
deviamos tapar estas coisas ?	should we be covering these things ?
a qualidade do ensino e diretamente proporcional ao acesso a faculdade , ao acesso aos empregos , ao acesso ao futuro .	the quality of your education is directly proportionate to your access to college , your access to jobs , your access to the future .
e esta autoestrada e na verdade muito boa comparada com o que vemos noutros paises onde o trafego esta em explosao .	and this highway is actually quite good compared to what you see in other countries where traffic is exploding .
eu duvido , mas e um caminho a explorar .	i doubt this , but it 's worth exploring .
mesmo perante as ameacas , manteve-se autentico .	even in the face of threats , he stayed authentic .
hoje , 20 anos depois , ainda nao ha outro metodo para controlar esta doenca .	today , 20 years later , there 's still no other method to control this disease .
para mim , essa e a felicidade profunda .	to me , that is deep happiness .
o nosso mundo e definido pelo ritmo da mudanca .	our world is defined by the pace of change .
`` temos tambem artigos chamados : `` como parecer que nao estiveste a chorar em menos de 5 minutos . '' ''	`` we also have articles called `` how to look like you were n't just crying in less than five minutes . '' ''
`` ( video ) narracao : `` '' nalguns dias . '' '' nalguns dias ponho as pessoas nos seus lugares a mesa , dobro-lhes as pernas pelos joelhos , caso venham com essa funcionalidade , e prendo-as as minusculas cadeiras de madeira . ''	`` ( video ) narration : `` '' some days . '' '' some days i put the people in their places at the table , bend their legs at the knees , if they come with that feature , and fix them into the tiny wooden chairs . ''
continuamos a desenvolver prototipos e , eventualmente , decidimos que queriamos ir a caverna . estavamos prontos .	we kept prototyping , and eventually , we decided we wanted to go to the cave . we were ready .
levantem-nos . um android , um blackberry . uau !	hold it up . an android , a blackberry , wow .
sou incrivelmente afortunado por viver neste momento da historia .	it makes me incredibly fortunate to live at this moment in history .
`` ok , entao `` '' estar melhor '' '' e so um numero ? ''	ok , so is better off just a number ?
qualquer que seja o ano quando os nosso detectores estiverem finalmente com uma sensibilidade avancada — iremos construi-los , ligaremos as maquinas e , bang , vamos apanha-la — a primeira cancao do espaco .	whatever year it will be when our detectors are finally at advanced sensitivity — we 'll build them , we 'll turn on the machines and , bang , we 'll catch it — the first song from space .
e o meu pai respondeu logo que ele sabia exatamente como a eliminar .	and my father immediately replied that he knew exactly how to bleach it .
esta e uma casa personalizada , de seis pisos , na ilha de bali .	this is a six-story bespoke home on the island of bali .
`` `` '' tenho paixao no coracao . ''	i have passion in my heart .
voces nao compreendem o que e ser capaz de entrar numa sapataria e comprar o que quiser .	like , you guys do n't understand what that 's like to be able to just go into a shoe store and buy whatever you want .
sofreram com a miseria alheia ?	did you sup on others ' squalor ?
e uma dadiva . voces nao o ganharam .	it 's a gift . you have n't earned it .
no decurso do meu trabalho tenho uma grande variedade de interesses .	in the course of doing my work i sort of have a broad range of interests .
mas estariamos errados .	you would be wrong .
vejamos os riscos .	let 's have some risks .
mas no final de contas , e um caminho bastante bom .	but all in all , it 's a pretty good path .
desde jovem que vi que ter um trabalho decente e ganhar bem fazia toda a diferenca para as familias que lutavam com as dificuldades .	and i saw from a young age that having a decent job and earning a good living made the biggest difference for families who were struggling .
entao nos temos ai , o que , por volta de mais 17 anos a frente antes que a china fique maior .	so we 've got , what , 17 more years to go or so before china 's bigger .
a abordagem rigida cria apenas complicacoes na organizacao .	the hard approach creates just complicatedness in the organization .
nao dao mais seguranca a ninguem .	they do n't make anyone safer .
os jornalistas nao sao autorizados a la entrar .	journalists are not allowed here .
em breve , seremos nove mil milhoes de pessoas .	there are nine billion humans coming our way .
tirei mais fotos , e comecamos o projeto .	i took more photos , and we started the project .
e e .	and it is .
ora eu penso que e uma ideia muito bela e uma ideia muito verdadeira .	now i think that 's a very beautiful idea and a very true idea .
se a parede em torno do tecido eretil nao existisse , se nao fosse assim reforcada , a forma mudaria , mas o penis inflado nao resistiria a dobras , e a erecao simplesmente nao daria certo .	if the wall around the erectile tissue was n't there , if it was n't reinforced in this way , the shape would change , but the inflated penis would not resist bending , and erection simply would n't work .
agora , quase todos nos trabalhamos em escritorios abertos , sem paredes , onde somos sujeitos	now , most of us work in open plan offices , without walls , where we are subject to the constant noise and gaze of our coworkers .
e isso leva-me a razao por que estou aqui .	and that brings me to the reason that i 'm here .
puxamos do telemovel , nao e ?	pull out the phone , right ?
se todos os vossos carros-robo estiverem a localizar as trajetorias previstas nao darao tanta atencao a esses pacotes .	if your robot cars are all tracking the predicted trajectories , you do n't pay as much attention to those packets .
e muitos de nos , quando vemos um uniforme a passar pelo nosso bairro , sentimos curiosidade , ou mesmo preocupacao .	and most of us , when we see someone in uniform going through our neighborhoods feel curiosity , if not concern .
ou isto poderia representar o relvado de uma universidade .	or this could represent a college green .
e comecaram a reprimir uns risinhos .	and start suppressing their church giggles .
bem , imaginemos que pegamos no telescopio espacial hubble e o rodamos e o deslocamos para a orbita de marte .	well to see , let 's imagine we take the hubble space telescope and we turn it around and we move it out to the orbit of mars .
quero uma casa , quero um carro .	i want a house , and i want a car .
e , para mim , isso e triste .	and that to me is sad .
como todos voces sabem , aquele retorno do exilio , o segundo templo , remodelou o judaismo .	as you all know , that return from exile , the second temple , reshaped judaism .
ficaram chocados ao descobrir que , por cada 100 adultos que fazem parte da populacao ativa do pais , 47 deles nao obteve o primeiro nivel de capacidades numericas .	and they were shocked to find out that for every 100 working age adults in the country , 47 of them lacked level 1 numeracy skills .
nao podemos criar mais tempo , mas o tempo estica-se para acomodar o que escolhemos fazer .	we can not make more time , but time will stretch to accommodate what we choose to put into it .
ha geracoes inteiras , em todo o mundo , que se perdem , por causa da guerra .	you know , there are generations around the world who are being lost to war .
muitos anos depois , vim a reconhecer que o problema que emma enfrentara era um problema de moldura .	many years later , i had come to recognize that the problem that emma was facing was a framing problem .
e quando me sentei naquele banco teste com a areia ainda a rodopiar a minha volta , a vedacao estava exactamente ao nivel dos olhos , barrando a vista e arruinando o espectaculo a borda de agua .	and when i sat down on that test bench with sand still swirling all around me , the railing hit exactly at eye level , blocking my view and ruining my experience at the water 's edge .
o que significa que haveria muito pouca resolucao o que chamamos deteccao no limite , e que alem disso , porque os olhos estavam completamente dilatados sob esta luz , a profundidade de campo , a distancia a que conseguimos focar e ver detalhes , teria sido de menos de 46 centimetros .	which means there would be very little resolution , what we call boundary or edge detection , and that furthermore , because the eyes would have been totally dilated under this light , the depth of field , the distance at which you can focus and see details , would have been less than 18 inches away .
`` tinha todas as qualidades do `` '' foie gras '' '' , mas a sua gordura tinha muita integridade e muita honestidade . ''	it had all the qualities of foie gras , but its fat had a lot of integrity and a lot of honesty .
e entao eles foram e estudaram 10 creches em haifa , israel .	and so they went and studied 10 daycare centers in haifa , israel .
os cirurgioes sao treinados , um passo de cada vez .	surgeons are trained one step at a time .
de facto , temos formas de vida fantasticas que podemos manipular .	in fact , we have such amazing lifeforms that we can manipulate .
portanto , vou-vos dar quatro .	so i 'll give you four .
mas , logo que uns tenis saem do mercado de retalho ,	but once a pair leaves the retail channel , it 's the wild west .
e eu desejava diversas coisas que nao estava a obter , ou nao estava a obter o suficiente .	and i was longing for several things that i was n't getting , or not getting enough of .
quando se perde a visao , a historia muda completamente .	lose your sight , though , and it 's a whole other story .
por outro lado , se acreditam que o restolhar na erva e apenas o vento , e afinal era um predador perigoso , voces servem de almoco .	on the other hand , if you believe that the rustle in the grass is just the wind , and it turns out it 's a dangerous predator , you 're lunch .
isto e claramente injusto e precisa de mudar .	that is manifestly unfair , and should change .
se puder deixar-vos com uma grande ideia hoje , e a de que o total da informacao que nos consumimos e maior do que a soma das partes e , em vez de pensarem em sobrecarga de informacao , gostaria que pensassem sobre como e que podemos usar a informacao para que surjam padroes e para que possamos ver tendencias que de outra forma seriam invisiveis .	if i can leave you with one big idea today , it 's that the whole of the data in which we consume is greater that the sum of the parts , and instead of thinking about information overload , what i 'd like you to think about is how we can use information so that patterns pop and we can see trends that would otherwise be invisible .
um dos elementos importantes e a imagiologia .	of course , one of the important elements is the imaging .
toda a campanha falhou , a malaria voltou a surgir , mas agora ainda era pior do que antes porque estava encurralada nos locais mais dificeis de alcancar nas formas mais dificeis de controlar .	the whole campaign crashed , malaria resurged back , but now it was even worse than before because it was corralled into the hardest-to-reach places in the most difficult-to-control forms .
`` voces estao a dizer a voces mesmos : `` '' sem ti , dispositivo de compromisso , eu nao sou nada , eu nao tenho autodisciplina . '' '' e depois quando voces estiverem numa situacao em que nao possuem um dispositivo de compromisso activo — por exemplo : `` '' oh meu deus , esta pessoa esta a oferecer-me um donut , e eu nao tenho um mecanismo de defesa , '' '' — voces irao simplesmente come-lo . ''	`` you 're just telling yourself , `` '' without you , commitment device , i am nothing , i have no self-discipline . '' '' and then when you 're ever in a situation where you do n't have a commitment device in place — like , `` '' oh my god , that person 's offering me a doughnut , and i have no defense mechanism , '' '' — you just eat it . ''
mas , lamentavelmente , a accao violenta - ainda que qualquer accao seja melhor do que nao fazer nada - mas a accao violenta e o participar na violencia tem o problema de que disfarca a violencia .	unfortunately , violent action — though action is better than no action — but taking part in it only disguises violence .
disc1 e um gene que e eliminado na esquizofrenia .	disc1 is a gene that 's deleted in schizophrenia .
`` quando tony tinha 16 anos , um dia , num momento , `` '' era a arma da minha mae . ''	`` when tony was 16 years old , one day , one moment , `` '' it was mom 's gun . ''
colocamo-nos em perigo .	we are endangering ourselves .
portanto , perguntei a minha operadora , a deutsche telekom , que na altura era a maior operadora de telecomunicacoes na alemanha . e pedi-lhes , por favor , enviem-me toda a informacao que tem guardada sobre mim .	so i asked my phone company , deutsche telekom , which was at that time the largest phone company in germany , and i asked them , please , send me all the information you have stored about me .
mas depois tem de regressar a cidade para testar as amostras num laboratorio central .	but then they would have to drive back into the city to test those samples in their central lab .
obrigada .	thank you .
as pessoas contam-me as suas vidas , as suas memorias , as suas aspiracoes , e eu crio uma paisagem mental .	people tell me their lives , their memories , their aspirations , and i create a mindscape .
podemos decidir interioriza estas mensagens negativas que nos estao a ser atiradas e deixarmo-nos sentir umas fracassadas , e pensar que o sucesso e muito dificil de alcancar , ou podemos decidir ver que a negatividade dos outros e problema deles e transformar essa negatividade na nossa energia pessoal .	you can either decide to internalize these negative messages that are being thrown at you , to let them make you feel like a failure , like success is way too hard to ever achieve , or you can choose to see that others ' negativity is their own issue , and instead transform it into your own personal fuel .
sao locais onde guardamos objetos de grande valor para nos , onde os apreciamos apenas por eles serem o que sao .	they 're places where we keep objects of great value to us , where we simply treasure them for them being themselves .
tem sido apenas recentemente que comeco a perceber que nao aprendi a sentar-me assim por ser indiano .	it 's only recently that i 've started to understand that i did n't learn to sit like this through being indian .
a maioria silenciosa precisa de saber .	the silent majority needs to know .
terceiro , diminuir os gastos per capita de forma continua .	three , decrease per capita expenditure across a continuum .
o que e que deviamos estar a estudar ?	what ought we to be studying ?
`` para criar `` '' lotus '' '' , esculpimos mais de 6000 figuras . ''	`` to create `` '' lotus , '' '' we carved over 6,000 figures . ''
a nossa longevidade aumenta quase um ano por cada ano que passa .	our life longevity is going up almost a year for every year that passes .
a escolha neste caso e bastante simples .	the choice in this case is pretty simple .
penso que as pessoas querem poder ser virtuosas .	i think people want to be allowed to be virtuous .
eu sinto-me optimista quanto a resolucao deste problema .	now , i 'm actually fairly optimistic that this problem can be solved .
este e um parque de esculturas em taejon .	this is in a sculpture park in taejon .
e veremos que os meus dois genomas , ou um deles que queiramos usar , tera por volta de tres milhoes de diferencas , nessa ordem .	and we will find that the two genomes in me , or one genome of mine we want to use , will have about three million differences in the order of that .
`` e isto tambem requer investimento , investimento — como por exemplo , em locais — locais onde nos podemos relacionar , locais onde pudemos participar , espacos partilhados , salas de concerto , jardins , parques publicos , bibliotecas , museus , centros tranquilos , locais de alegria e celebracao , locais de tranquilidade e contemplacao , sitios para a `` '' cultivacao de uma cidadania comum . '' '' segundo uma bela frase de michael sandel . ''	`` and this too requires investment , investment — for example , in places — places where we can connect , places where we can participate , shared spaces , concert halls , gardens , public parks , libraries , museums , quiet centers , places of joy and celebration , places of tranquility and contemplation , sites for the `` '' cultivation of a common citizenship , '' '' in michael sandel 's lovely phrase . ''
como dane atkinson .	like dane atkinson .
talvez , perante a pressao constante , o meu instinto primario de sobrevivencia se tenha conectado com os arcos .	perhaps , in the face of constant pressure , my caveman instinct of survival has connected with the bows .
o mark vai-me dar uma boleia de volta ao hotel .	mark 's going to give me a ride back to the hotel .
e a ideia de inovacao sem autorizacao .	it 's the idea of permission-less innovation .
nao podemos viver com ele , mas tambem nao podemos viver sem ele .	we ca n't live with it ; we ca n't live without it .
por vezes , e quase assustador .	sometimes , it 's almost creepy .
mas notei tambem que , as vezes , a musica que havia escrito , ou estava a escrever na epoca , nao soava muito bem nalguns daqueles sitios .	but i also noticed that sometimes the music that i had written , or was writing at the time , did n't sound all that great in some of those halls .
muito obrigado .	thank you very much .
o que descobrimos e que estas divisoes permaneciam relativamente estagnadas ate sabado , quando abriamos novamente os respiradouros .	what we found is that these rooms remained relatively stagnant until saturday , when we opened the vents up again .
eu nasci em 1971 .	i was born in 1971 .
testei-as .	and i tested them .
onde quer que eu fosse , sentia-me em casa .	everywhere i went , i felt at home .
a musica era diferente em alguns aspectos , mas na estrutura e na forma , basicamente a mesma .	the music was in some ways different , but in structure and form , very much the same .
se o mudarem de sitio , ele acaba no local errado .	if you displace it , it ends up in the wrong place .
existem numa variedade desconcertante de diferentes tipos .	they come in a bewildering variety of different kinds .
cria um contraste que consegue ver .	it 's creating contrast that they can indeed see .
no ano passado , um dos nossos parceiros , o colegio americano de cirurgioes , uniu-se a nos para anunciar que todos os cirurgioes devem ter uma certificacao fls ( fundamentos de cirurgia laparoscopica ) antes de fazerem cirurgias minimamente invasivas .	now just this past year , one of our partners , the american college of surgeons , teamed up with us to make an announcement that all surgeons should be fls ( fundamentals of laparoscopic surgery ) -certified before they do minimally invasive surgery .
mas em vez disso , levamos uma camara as profundezas do oceano , e vemos um peixe que nao cativa a nossa imaginacao como sociedade .	but instead , we stick a camera in the deep ocean , and we see a fish , and it does n't capture our imagination as a society .
isto nao e feito com o photoshop .	this is n't photoshopped .
claro que , tendo novos olhos , ate as paisagens antigas , ou o nosso lar se tornam algo diferente .	and of course , once you have new eyes , even the old sights , even your home become something different .
( risos ) tambem nas vendas , os rendimentos mais baixos eram dos vendedores mais generosos .	( laughter ) and then in sales , too , the lowest revenue accrued in the most generous salespeople .
( aplausos )	( applause )
queremos sensores , potencia , controlo , tudo acionado em conjunto . nem tudo tem que ser inspirado na biologia .	we want sensing , power , control , actuation all together , and not everything needs to be bio-inspired .
um programa curricular mesmo rapido .	really quick syllabus .
`` vai fazer quatro anos , e toda a gente sabe que quando se tem quatro anos adoramos perguntar : `` '' porque ? '' '' sim . porque . ''	`` she 's going to be four years old , and anyone who knows a four-year-old knows that they love to ask , `` '' why ? '' '' yeah . why . ''
o afeganistao e um dos paises mais pobres do mundo , e 70 % da populacao e analfabeta .	afghanistan is one of the poorest countries in the world , and 70 percent of the people are illiterate .
errado , outra vez . ja la vao seis anos e meio desde a introducao destes custos em estocolmo , e ainda se verificam os mesmos baixos niveis de transito .	wrong again . it 's now six and a half years ago since the congestion charges were introduced in stockholm , and we basically have the same low traffic levels still .
para encerrar esta parte , numa sintese , queria dizer uma coisa um pouco controversa .	to close this part and sum up , i 'd like to talk about something a little different .
mas deu-me uma chavena de cha .	but he gave me a cup of tea .
ca : este interior e desenhado pelo philippe starck ?	ca : so this interior is philippe starcke designed ?
hoje , passados 25 , 30 anos falamos de uma taxa de mortalidade que diminuiu em 85 % .	today , some 25 , 30 years later , we 're talking about a mortality rate that 's reduced by 85 percent .
o que e que quero dizer com isso ?	what do i mean by that ?
e como sao os criminosos informaticos de hoje ?	today 's cybercriminal , what do they look like ?
mas as linhas que transportam informacao significativa sao normalmente muito curtas . tem entre poucas dezenas e varios milhares de letras .	but the lines that carry meaningful information are usually very short — a few dozen to several thousand letters long .
ruminar significa remoer .	to ruminate means to chew over .
a verdade nunca e binaria . a verdade e um valor .	truth is never binary . truth is a value .
mas voces tambem precisam de fornecer provas uteis de que sao dignos de confianca .	but you also have to provide usable evidence that you are trustworthy .
agora , podemos realmente miniaturizar laboratorios biologicos e quimicos em chips de microfluidos .	so , right now , we can actually miniaturize biological and chemistry laboratories onto microfluidic chips .
dois anos mais tarde , a fome atingiu o meu pais pela segunda vez .	two years later , famine hit my country for the second time .
talvez haja mais pessoas do meu povo la fora .	maybe there are more of my people out there .
assim , ninguem estava a economizar energia . e o que aconteceu ?	so no one was saving energy , and what happened ?
algo que podem fazer com uma imagem destas e simplesmente admira-la .	one thing you can do with a picture like this is simply admire it .
isso significa que ha um constante , enorme volume de dados a passar .	and what that means is just constant , huge volumes of data going up .
muitos sao os que procuram .	many seek .
este e o fenomeno mais conhecido do mundo quantico , o efeito tunel .	this is one of the best-known phenomena in the quantum world , quantum tunneling .
todas estas areas verdes , sao os ambientes ricos em alvos .	so all of the green areas , these are your target-rich environments .
onde pensam que vai haver mais acao ?	where do you think the action is going to be ?
e ha tecido muscular normal por cima dele . veem ?	there 's actually normal muscle on top of it . see that ?
mas , antes de podermos fazer vida , vamos pensar por um segundo sobre o que realmente caracteriza a vida .	but before we can make life , let 's think for a second what life really is characterized by .
e por isso , foi uma experiencia incrivelmente forte .	and so it was just an incredibly powerful experience .
quando eu era uma crianca , eu adorava construir coisas , e criar maquinas complicadas .	when i was a child , i loved to build stuff , to create complicated machines .
o verdadeiro potencial , o potencial a longo prazo , reside nesta comunidade «faca voce mesmo» de exploradores oceanograficos . que se esta a formar a volta do globo .	the real potential , the long term potential , is with this community of diy ocean explorers that are forming all over the globe .
mas , sim , ha 30 anos que escrevo historias sobre abusos de poder , e , quando falo dos poderosos do meio militar ou da industria farmaceutica , toda a gente bate palmas .	but yeah , for 30 years i 've been writing stories about abuses of power , and when i say the powerful people over there in the military , or in the pharmaceutical industry , everybody applauds me .
ele preparou programas antecipando que isto aconteceria .	he prepared programs anticipating this would happen .
por isso , esta nas vossas maos .	so , it really is down to you .
ora bem , os espacos abertos nas cidades sao oportunidades ,	now , open spaces in cities are opportunities .
mas acima de tudo , afeta os pacientes , esses podem ser voces , posso ser eu .	most of all , though , it affects the patients , and that could be you , it could be me .
( risos ) chama-se adam rifkin .	( laughter ) his name is adam rifkin .
provavelmente ha cerca de 15 mil criancas a ser treinadas enquanto falamos .	actually , probably about 15,000 children are being trained as we speak .
sim , quando se reformarem , os falantes de linguas sem futuro , com um rendimento constante vao reformar-se com 25 % mais em poupancas .	yes , by the time they retire , futureless language speakers , holding constant their income , are going to retire with 25 percent more in savings .
por isso , o calculo tem sido ensinado tradicionalmente muito tarde .	so calculus has traditionally been taught very late .
fui-me esconder no meu quarto , escondi-me debaixo dos cobertores , e depois esperei que o meu pai voltasse do trabalho com , pode-se dizer , muita apreensao .	i went to hide in my bedroom , under the blankets , and then i waited for my father to come back from work with , one could say , much apprehension .
o que havemos de fazer quanto a este grande problema das abelhas que criamos ?	what are we going to do about this big bee bummer that we 've created ?
descodifica-se o que se quer ver dobrar , numa sequencia de angulos — entao menos 120 , menos 120 , 0 , 0 , 120 , menos 120 — algo assim ; uma sequencia de angulos , ou curvas , e envia-se essa sequencia ao longo do fio .	you decode what you want to fold up into , into a sequence of angles — so negative 120 , negative 120 , 0 , 0 , 120 , negative 120 — something like that ; so a sequence of angles , or turns , and you send that sequence through the string .
agora , todos deveriam esperar que quando a degradacao do oleo acontece , quando os constituintes sao libertos , eles desaparecem , vao-se , porque foram absorvidos .	now everyone would expect that when the degradation of the oil happens , when the constituents are liberated , they disappear , they go away because they [ were ] absorbed .
o anfitriao levou-o a correr para o hospital .	the host rushed him to the hospital .
a degradacao dos meus olhos quebrou a ilusao .	the deterioration of my eyes shattered the illusion .
entao ha otimismo .	so there 's the optimism .
pensem nisso .	so think about that .
estavam a fazer diarios detalhados dos seus gastos , do seu estado de humor , dos seus sintomas , dos seus tratamentos .	they were making detailed journals of their spending , their mood , their symptoms , their treatments .
e por isso que os civis paquistaneses , mais de 6.000 dos quais foram mortos so nos ultimos dois anos , sao alvos aceitaveis .	that 's why pakistani civilians , over 6,000 of whom have been killed in the last two years alone , are fair game .
ainda assim , adoro imagina-lo .	but still , i love imagining it .
mas tambem ha outras empresas que ja estao a agir .	but also , there are other businesses already acting .
entao eu quero apenas oferecer quatro questoes que todos os pacientes devem perguntar , porque eu nao espero que as pessoas realmente comessem a desenvolver este tipo de relatorios .	so i want to just offer four questions that every patient should ask , because i do n't actually expect people to start developing these lab test reports .
portanto , passo numero tres desta viagem : nos sabemos que , se vamos continuar a progredir vamos ter de aumentar o volume , vamos ter de aumentar a visibilidade , e vamos ter de incluir o publico .	and so , step number three on this journey : we know , if we 're going to keep making this progress , we 're going to have to turn up the volume , we 're going to have to increase the visibility , and we 're going to have to engage the public .
imaginem por um momento que em vez de terem o tim harford a vossa frente era o hans rosling a apresentar os seus graficos .	imagine for a moment that , instead of tim harford in front of you , there was hans rosling presenting his graphs .
entao estao aqui tres pessoas que falam a lingua inglesa .	so here are three speakers of the english language .
o meu sonho pessoal e que as criancas peguem nisto , explorem e vejam as maravilhas que existem , e que se inspirem , como quando fui jovem , a perseguir o ramo cientifico e a perseguir o sonho da exploracao espacial .	and my personal dream is for kids to take this and explore and see the wonders out there and be inspired , as i was as a kid , to pursue stem education and to pursue a dream in space exploration .
esta e a minha primeira dica : recuar para ter uma visao mais ampla .	so that 's my first tip : look broader .
e o resultado de muito prologado e sustentado ativismo politico que nos obtemos os regulamentos certos , e obtemos o comportamento certo das companhias .	it 's the result of very sustained and prolonged political activism that you get the right regulations , and that you get the right corporate behavior .
( aplausos )	( applause )
( aplausos ) agora , o povo levantou preocupacoes reais sobre o que significa o crescimento de partidos islamitas para as mulheres .	( applause ) now people have raised some real concerns about what the rise of islamist parties means for women .
se nao tiverem qualquer dano , entao vao para o supermercado .	if they do n't have any damage , they go to the grocery .
`` ha muitos `` '' sites '' '' onde pessoas comecaram a reunir uma carta magna , uma declaracao de direitos para a `` '' web '' '' . ''	there are lots of sites where people have started to put together a magna carta , a bill of rights for the web .
e este e o sistema de monitorizacao de sono de hoje em dia .	and this is the sleep tracking system of today .
as empresas podem ate dar controlo aos hackers .	companies can even give control to hackers .
eu vou percorrer algumas das fotografias desta serie .	i 'm going to run through some of the photographs in this series .
ele adere , abre caminho por entre as camadas celulares , atraves do poro , surge do outro lado da membrana , e ai , ira envolver a bacteria marcada a verde .	it sticks , it wiggles its way through between the cell layers , through the pore , comes out on the other side of the membrane , and right there , it 's going to engulf the bacteria labeled in green .
( aplausos )	( applause )
o problema da imagem do depois , e que nao tem o modulo .	the only problem with the after image is , there is no lander .
rodemos e olhemos para mim frontalmente .	but let 's swivel around and look at me frontally .
abanamos as coisas e vemos o que acontece .	we shake things and see what happens .
`` de modo que batalhei para sair da minha editora . e no meu projeto seguinte , com a minha nova banda , `` '' the grand theft orchestra '' '' , virei-me para o crowdfunding [ financiamento colaborativo ] . ''	so i fought my way off my label , and for my next project with my new band , the grand theft orchestra , i turned to crowdfunding .
ele era aproximadamente 20 anos mais velho que todos os outros na amostra .	he was 20-some years older than anybody else in the sample .
temos de encontrar o passo certo para bloquear e criar um medicamento que o faca .	we have to find the right step to block , and then create a drug that does it .
nas vossas maos , espero que esteja um pedaco de cartao .	in your hands , you hopefully hold a piece of cardboard .
este pequeno video e da ultima semana .	this short video is from last week .
nao tenho a certeza se devemos ver os jovens como nativos digitais .	i 'm not so sure we should be thinking of young people as digital natives .
e nao estamos apenas a investir nos miudos .	and we 're not just investing in the kids .
nao entendo porque e que isto esta sempre a acontecer .	i do n't understand why this keeps happening .
cidadaos globais , inovadores , lideres empresariais , individuos , precisamos de voces .	global citizens , innovators , business leaders , individuals , we need you .
usando este processo , para cada um dos diferentes grupos , temos agora uma taxa de sucesso de 80 % , na classificacao de 1,5 milhoes de imagens .	and using this kind of process for each of the different groups , we are now up to an 80 percent success rate in classifying the 1.5 million images .
outro dispositivo e a speedstrip .	another device is called speedstrip .
isso apenas nos deu maior determinacao em provar que se podia construir uma historia melhor .	that just gave us more determination to prove that you could build a better story .
a bondade pode soar como uma palavra muito moderada , e esta sujeita ao seu proprio , grande cliche .	`` now `` '' kindness '' '' might sound like a very mild word , and it 's prone to its own abundant cliche . ''
assim , ao projetarem uma cidade para os cegos , espero que comecem a perceber que isso seria , na verdade , mais inclusivo , uma cidade com mais equidade , mais justa para todos ,	so , in designing a city for the blind , i hope you start to realize that it actually would be a more inclusive , a more equitable , a more just city for all .
outras vezes , nao sao sequer historias minhas .	other times , it 's not even my stories .
era uma meta terrivel !	that 's a terrible end !
nao sabemos as respostas , nao sabemos se as vamos encontrar , mas sabemos que o risco e elevado .	we do n't know the answers , we do n't know if we 're going to find them , and we know that the risks are high .
mas primeiro , preciso de vos contar uma historia , que e a minha historia , a historia deste pais onde voces estao hoje .	but first , i need to talk to you about a story , which is my story , about the story of this country that you 're all here in today .
muitos dos meus colegas e cientistas diriam que ja e demasiado tarde para impedir um aquecimento de 2º c .	there are quite a lot of my colleagues and other scientists who would say that it 's now too late to avoid a two-degree warming .
simplesmente , ainda nao tinhamos atingido isso .	we just have n't caught up with the actual realities of this .
e , na realidade , isto resultou muito bem .	well , as it turns out , this worked pretty well .
uma maior distribuicao dos meios de produccao , cadeias de abastecimento que respeitam o ambiente , e um renascer da cultura do faca-voce-mesmo podem transcender a escassez artificial .	a greater distribution of the means of production , environmentally sound supply chains , and a newly relevant diy maker culture can hope to transcend artificial scarcity .
eu gostaria de falar de uma forma de pensar sobre as tendencias tecnologicas a que chamo a minha grande teoria unificada de prever o futuro , mas que e mais como uma pequena teoria unificada de prever o futuro .	`` i 'd like to talk about a way of thinking about technology trends that i call my `` '' grand unified theory of predicting the future , '' '' but it 's closer to a petite unified theory of predicting the future . ''
a africa e um lugar onde as pessoas ainda se sentam sob o ceu estrelado , em torno de fogueiras ao ar livre e contam historias . o que tenho para partilhar hoje e a simples mezinha de algumas historias contadas a fogueira . historias sobre herois de coragem e coracao .	africa is a place where people still sit under starlit skies and around campfires and tell stories , and so what i have to share with you today is the simple medicine of a few campfire stories , stories about heroes of heart .
isto prende-se com o problema fundamental que temos com o desenvolvimento de vacinas para doencas infeciosas .	this goes to the fundamental problem we have with vaccine development for infectious diseases .
`` `` '' porque , na verdade , ela e inocente ; todos o sabem . ''	because she 's blameless ; everybody knows it .
o que isto tem de fantastico e que nao e dificil fazer estas coisas .	what 's also really cool here is it 's not that hard to make these things .
fomos vitimas dos espanhois .	we were victims of the spaniards .
as noticias adoraram .	the news loved it .
e o fundamental e termos uma relacao entre o tempo de conducao e o de paragem , de aproximadamente 6 ou 7 [ horas ] .	and the key thing is to have a ratio of drive to stop , to stop time , of about six or seven .
mas , infelizmente , doencas neurologicas como a doenca de parkinson destroem gradualmente esta capacidade extraordinaria , como esta a acontecer com o meu amigo jan stripling , que era um bailarino virtuoso no seu tempo .	now , sadly , neurological disorders such as parkinson 's disease gradually destroy this extraordinary ability , as it is doing to my friend jan stripling , who was a virtuoso ballet dancer in his time .
( aplausos ) e derrotaram a proposta .	( applause ) and they defeated the proposal .
deveriamos todos olhar para a lua mais vezes . nao o fazemos .	we should all look at the moon a bit more often . we do n't .
limitamo-nos a ler a etiqueta na parte de tras de uma embalagem .	we just read the back of a label on a packet .
a segunda sao estacoes terrestres automatizadas , onde os veiculos descolam e aterram para trocar baterias e voar mais longe , ou receber ou entregar cargas .	the second is automated ground stations that the vehicles fly in and out of to swap batteries and fly farther , or pick up or deliver loads .
e voces ?	are you ?
obrigada .	thank you .
no entanto , para o proposito de proteger a sua privacidade as custas da fiabilidade do gps , existe algo ainda mais potente e mais subversivo do que o wave bubble , que e um imitador de gps .	but as it turns out , for purposes of protecting your privacy at the expense of general gps reliability , there 's something even more potent and more subversive than a wave bubble , and that is a gps spoofer .
e a forma mais dificil , nao e uma coisa banal , mas , neste caso , e a unica forma .	and it 's the hard way , and this is not trivial , but in this case , it 's the only way .
ou cerca de 75 000 empregos .	or about 75,000 jobs .
nao estou a dizer que nao precisamos de hoteis ou das formas de autoridade tradicionais .	i am not saying we do not need hotels or traditional forms of authority .
e tem de por em risco as suas vidas todos os dias para fazer isto .	and they have to risk their lives almost every day to do this .
por que e que , atualmente , todos os caminhoes de lixo na california do sul sao a gas natural ?	why are all the trash trucks today in southern california on natural gas ?
`` vi aquele programa de tv 'lie to me ' ( mente-me ) . sei que estas a mentir . '' '' nao , os apanhadores de mentiras estao armados com conhecimento cientifico sobre como detectar o engano . ''	`` i watch that tv show 'lie to me . ' i know you 're lying . '' '' no , liespotters are armed with scientific knowledge of how to spot deception . ''
o visor e um smartphone que mostra os parametros do sistema	the heads-up display is a smartphone that displays system parameters .
e participaram os reporteres e os produtores .	and they had the reporters and their producers participate .
eles estao a aprender sobre si mesmos	they 're learning who they are .
ja foram construidas 2 cidades na china e estao a preparar a terceira .	they 've actually built two cities already in china and are preparing the third .
para iniciantes , agora vivemos mais anos , e , como tal , envelhecemos mais lentamente .	for starters , we now live longer , and so age more slowly .
quando consegue faze-lo com sucesso , o humano que esta a comanda-lo pode indicar areas de interesse .	and when it does so successfully , the human who is driving it can then point out the areas that are interesting .
nao foi o meu ponto alto de 2012 .	it was n't my highlight of 2012 .
eu quero dizer , realmente a informacao parece ser a nossa maior esperanca	i mean really though , information seems like our best hope .
tambem diziam que o transito era assimetrico , o que significa que , em vez da depressao limpa em u que viamos em jupiter , tinha esta inclinacao estranha que se ve no lado esquerdo .	they were also saying that it looks asymmetric , meaning that instead of the clean , u-shaped dip that we saw with jupiter , it had this strange slope that you can see on the left side .
bom , nada agradavel .	well , nothing pleasant .
`` sistemas de `` '' post-its '' '' nao so sao mais fluidos , mas tambem geram mais nos que desenhos estaticos . ''	so sticky note systems are not only more fluid , they generally produce way more nodes than static drawings .
os doentes ainda estao na mesa do bloco operatorio .	patients are still on the operating room table .
tal como o figado e os rins , fazem a limpeza do ar .	like the liver and the kidneys , as i 've said , cleaning the air .
( risos ) bem , estao errados .	( laughter ) so , you 're wrong .
`` mas depois parei , porque achei `` '' ja sou bom que chegue ''	`` but then i stopped because i figured , `` '' hey , i 'm good enough . ''
e garantido , muitas delas sao mentiras inofensivas .	now granted , many of those are white lies .
e lembro-me de andar pelo corredor do capitolio dos e.u.a. , estava nos meus trintas , e a minha vida tinha um proposito , e eu nao podia imaginar que alguma vez alguem iria desafiar este pedaco de legislacao importante .	and i remember walking through the halls of the u.s. capitol , and i was in my 30s , and my life had purpose , and i could n't imagine that anybody would ever challenge this important piece of legislation .
aquilo foi filmado a partir de um helicoptero utilizando uma camera giro-estabilizada .	that was filmed from a helicopter using a gyro-stabilized camera .
para conseguir isto , precisamos do tipo certo de linguagem .	now , in order to do this , we need the right kind of language .
tendo seguido uma carreira militar e acabando por se tornar num astronauta .	you 're going into the military and eventually to become an astronaut .
isto tem de parar , e eu gostava que essa mudanca pudesse vir das instituicoes do topo , que perpetuam estes problemas , e eu imploro , eu suplico para que elas parem .	this needs to stop , and i wish that the change could come from the institutions at the top that are perpetuating these problems , and i beg them , i beseech them to just stop it .
`` o barulho surgiu : `` '' o que e isto ? o que esta a acontecer ? ''	`` big noise raised up : `` '' what is this ? what is happening ? ''
teria de fazer parte da sua identidade .	it had to be part of their identity .
porque sera que a tensao alta e tao mortal para os negros ?	so why is high blood pressure so differentially deadly for black men ?
contudo , na maior parte das vezes , as pessoas nao pensam numa coisa destas , que e a outra face da moeda .	but people are often not thinking of something like this , which is the other end of the spectrum .
cria um portal para a vossa voz interior se elevar e ser ouvida .	`` it creates a gateway for your inner voice to rise up and be heard . and `` '' god '' '' ? ''
podemos ver como estes dois mundos colidem .	you can see how these two worlds collide .
mas isso esta a comecar a mudar .	this is beginning to change .
a mobilidade nas cidades do mundo em desenvolvimento e um desafio muito peculiar , porque e diferente da saude , ou educacao ou habitacao , tende a tornar-se pior quando as sociedades enriquecem .	mobility in developing world cities is a very peculiar challenge , because different from health or education or housing , it tends to get worse as societies become richer .
bem , recolhendo , histericamente , simbolos de desejabilidade .	well , by hysterically collecting symbols of desirability .
`` e podia-se ouvir aquele pequeno `` '' tique , tique , tique , tique '' '' . ''	and you could hear that little tick , tick , tick , tick .
chamo-me debra brown .	my name is debra brown .
isso acabou por se descontrolar tanto que um jornal local fez uma historia sobre o lado negro da nintendo , em que eu era o protagonista .	eventually it got so out of hand that a local newspaper came and did a story on the dark side of nintendo , starring me .
nao deveriamos deixar ninguem por isso em causa .	we should not let anybody take that away from us .
a maior diferenca entre os seres humanos e todos os outros animais nao esta a nivel individual , mas a nivel coletivo .	the real difference between humans and all other animals is not on the individual level ; it 's on the collective level .
populamos todas as ecologias .	we populated all the ecologies .
sao caros . sao dificeis de visitar .	and they 're expensive to get to . they 're hard to visit .
assim , creio que ha muitas maneiras diferentes para que as pessoas se possam expressar usando isto , e assim partilhar as suas ideias com o mundo .	so i think there 's so many different ways that people can express themselves using this , to be able to take their ideas and share their ideas with the world .
os nervos sao amarelos , as arterias vermelhas , as veias sao azuis .	nerves are yellow , arteries are red , veins are blue .
e usado na tinta para lhe dar textura , mas tambem reflectir a luz .	it 's used in paint for the texture , but also for the glossiness .
estao a ver o que eu estou a fazer aqui ?	do you see what i 'm doing here ?
alteram-nos para serem os personagens que querem ser nessas producoes .	they change them to be the characters they want to be in those productions .
e precisam de um quarto fator , que talvez seja o fator mais importante .	and you need the fourth factor , which perhaps is the most important factor .
`` elas viraram-se para ele e disseram `` '' vamos fazer com que nao seja reeleito '' '' . ''	`` these little girls turned to him and said , `` we will vote you out of office . '' ''
esta e uma das estrategias . usamos uma impressora .	this is actually one of the strategies . we use a printer .
nunca cheguei a conhece-lo ,	i never got to meet him .
vezes demais , a historia e aquilo a que chamo o modelo de mount rushmore .	too often , i think history 's what i call the mount rushmore model .
bem , existe vida alem da terra no sistema solar ?	well , is there life beyond earth in the solar system ?
mas se existe energia escura , e a energia escura nao desaparece , o universo vai simplesmente continuar a expandir-se sempre , e sempre e sempre .	but if there 's dark energy , and the dark energy does not go away , the universe is just going to keep expanding forever and ever and ever .
de onde vem isto ?	so where did this come from ?
foram necessarias decadas antes que o termo buraco negro fosse cunhado e as pessoas se apercebessem que os buracos negros sao objetos astrofisicos reais — de facto sao o estado de morte de estrelas muito massivas que colapsam catastroficamente no final das suas vidas .	`` it was decades before the term `` '' black hole '' '' was coined and people realized that black holes are real astrophysical objects — in fact they 're the death state of very massive stars that collapse catastrophically at the end of their lifetime . ''
quero apenas realcar duas questoes que penso serem uteis .	i want to just point out two questions that i think are useful .
eu penso que , nao ha como uma crise para nos dizer o que e verdadeiramente importante e o que nao o e , e o sandy fez-me ver a importancia que os nossos aparelhos e a sua conectividade tem para nos e bem alta , ao nivel da comida e abrigo .	i think there 's nothing like a crisis to tell you what 's really important and what 's not , and sandy made me realize that our devices and their connectivity matter to us right up there with food and shelter .
( aplausos )	( applause )
a boa noticia e que nao somos desprovidos de poder .	the good thing is that we are not powerless .
entao porque nao comemos insectos ?	so why are we not eating insects yet ?
a camada de gelo arctico e , de certo modo , o coracao do sistema climaterico global .	the arctic ice cap is , in a sense , the beating heart of the global climate system .
mergulhar mais profundamente nisto com o conselho da ciencia e tecnologia da academia de artes e ciencias cinematograficas revela mais verdade por detras dos truques .	so digging deeper into this with the science and technology council of the academy of motion picture arts and sciences reveals some truth behind the trickery .
`` quando ele falava sobre as series , nao falava sobre o george jefferson de hollywood em `` '' the jeffersons '' '' ou na serie que estava no numero cinco da tabela . ''	`` and when he talked about the shows , he was n't talking about the hollywood , george jefferson in `` '' the jeffersons , '' '' or the show that was a number five show . ''
( risos ) mas se reordenarmos rapidamente esta formula , conseguimos chegar a aceleracao igual a forca sobre a massa , o que significa que para uma particula maior , uma massa maior , esta requer mais forca para mudar a sua direcao .	( laughter ) but if we rearrange this formula quickly , we can get to acceleration equals force over mass , which means that for a larger particle — a larger mass — it requires more force to change its direction .
e em vez de partilharem dinheiro , eles tornaram-se egoistas .	and instead of sharing money , they become selfish .
muito obrigado por inventares a economia comportamental .	thank you so much for inventing behavioral economics .
eu confrontei-os com um problema , que era montar um forum de eleicoes para a sua propria comunidade .	i posed a problem in front of them , which was to put on an election forum for their own community .
a area azul e onde sabemos que ele deve estar .	the blue area here is where we know it must be .
o pessoal da limpeza entra rapidamente , o corpo e retirado , ate parece que aquela pessoa nunca existiu .	cleaning crew swoops in , the body 's whisked away , and it all feels as though that person had never really existed .
e recapitulam aquela forma , mesmo sendo este um circulo de nove e este um circulo de 36. e de doidos !	and they recapitulate that shape , even though that 's a circle of nine and that 's a circle of 36. it 's nuts .
se morreram , que idade tinham e em que ano aconteceu ?	if they died , at what age and what year ?
infelizmente , foi desenhada como se fosse a sede de uma empresa , com um atrio central enorme e salas de aulas a volta , sem paredes a separar .	unfortunately , it was designed like a corporate headquarters , with a vast central atrium and classrooms leading off it with no back walls at all .
conseguem ver esta mao ?	see this hand ?
mas , de varias maneiras , esses desenhos microanatomicos de ramon y cajal , como este , ainda sao , de certa forma , insuperaveis .	but in many ways , these microanatomical drawings of ramon y cajal 's , like this one , they 're still in some ways unsurpassed .
nenhum destes esta na minha lista de desejos .	none of those are on my bucket list .
e o melhor de tudo e que encaixam com imas .	and the best part about it is they snap together with magnets .
bg : entao , foi um dos primeiros no brasil .	bg : so it was one of your first ones in brazil .
eles sao espertos .	they 're smart .
agite-no , e tem um casal lesbico .	shake it , and you have a lesbian couple .
parece adoentado .	it looks sickly .
e exatamente a mesma pergunta que me fizeram quando eu estava a arquitetar o plano	and that 's the exactly the same question i got when i was developing a plan to combat deforestation .
os membros eram encorajados a trazer as esposas , filhas e irmas aos encontros da associacao britanica , e enquanto se esperava que as mulheres assistissem apenas as palestras publicas e eventos sociais como este , elas comecaram tambem a infiltrar-se nas sessoes cientificas .	members were encouraged to bring their wives , daughters and sisters to the meetings of the british association , and while the women were expected to attend only the public lectures and the social events like this one , they began to infiltrate the scientific sessions as well .
e como que uma gramatica . sei o que vou fazer com ela e posso comecar a descreve-la . posso descreve-la de forma muito simples . posso descreve-la com os meus bracos , certo ?	it has a kind of a grammar . i know what i 'm going to do with it , and i can start to describe it , so i can describe it very simply . i can describe it in my arms , right ?
mr : agradeco-lhe mesmo muito , cynthia kenyon .	mr : thank you very much indeed , cynthia kenyon .
o mesmo e verdade para a tecnologia pessoal de adn , hoje .	and the same is true for personal dna technology today .
nao tem origem magmatica nem vulcanica , e , repito , a mais de 700 km do centro vulcanico mais proximo .	it 's neither magmatic or volcanic in origin , and again , over 700 kilometers away from the nearest volcanic center .
mas ha mais um problema .	ok , but there 's one more problem .
essas fibras nessa orientacao particular dao ao esqueleto um comportamento totalmente diferente .	those fibers in that particular orientation give the skeleton a very , very different behavior .
e tambem eles fazem referencia a como a uvula — tudo o que verbalizam e cadente , por causa do fruto proibido .	and also they reference how the uvula — everything they say is fallen because of the forbidden fruit .
e isso para mim seria um mau comeco da vida depois da morte , ter de testemunhar o proprio funeral e sentir-me satisfeito .	and that to me was a bad start to the afterlife , having to witness your own funeral and feel gratified .
porque os lideres do governo nas honduras necessitam de ajuda da parte dos paises parceiros , que poderao beneficiar dos paises parceiros que os ajudarao a estabelecer as regras neste fretamento assim como o seu reenforco , de modo que todos acreditem que o conceito fretado sera bem implementado .	because the leaders in the government there in honduras would need help from partner countries , who could benefit from partner countries who help them set up the rules in this charter and the enforcement , so everybody can trust that the charter really will be enforced .
e de longe a maior biblioteca de textos impressos no mundo .	it is , by far and away , the largest print library in the world .
mas , se calhar para mim , a parte principal , a longo prazo , e a ideia de pegarmos nas nossas proprias celulas estaminais com os nossos genes e o nosso ambiente , e imprimirmos os nossos medicamentos personalizados .	but perhaps for me the core bit going into the future is this idea of taking your own stem cells , with your genes and your environment , and you print your own personal medicine .
eu tinha quase cinco anos . e justo dizer que estou a divertir-me muito mais do que o pai natal .	i 'm almost five years old . fair to say , i 'm enjoying the day a lot more than santa was .
existe alguma coisa que as empresas possam fazer para que os seus colaboradores se sintam menos pressionados pelo tempo ? sim .	is there anything companies can do to make their employees feel less pressed for time ? yes .
entao , isto constitui um desafio para o proximo seculo .	and so , this makes this coming century a challenge .
como podem ver , esta e uma imagem de uma tigela de sopa .	you see that this is a picture of a bowl of soup .
`` `` '' se quiseres uma ideia nova , `` '' tens que abrir um livro antigo '' '' . e eu vou dizer que esse livro ja foi escrito . ''	`` he said , `` '' if you want a new idea , you should open an old book . '' '' and i 'm going to say that the book was written . ''
entao ela criou um grupo de apoio para pais como ela .	so she created a support group for parents like her .
entao para fazer isto piscar mais rapido ou mais devagar , podem girar este parafuso e basicamente faze-lo piscar mais rapido ou mais devagar .	so to make this blink faster or slower , you would just turn this knob and basically make it pulse faster or slower .
a palavra e essencialmente uma representacao abstracta , uma representacao totalmente arbitraria duma coisa que existe no mundo real , e isso e uma coisa que as criancas autistas tem uma dificuldade terrivel em perceber .	so it 's essentially a completely abstract , a completely arbitrary representation of something which is in the real world , and this is something that children with autism have an incredible amount of difficulty with .
quando os portugueses chegaram a america latina ha cerca de 500 anos , encontraram esta espantosa floresta tropical .	when the portuguese arrived in latin america about 500 years ago , they obviously found this amazing tropical forest .
e a sua maquina , que era tao grande como uma maquina de lavar , foi lancada a 13 de janeiro de 1976 .	and his machine , which was as big as a washing machine , was launched on the 13th of january , 1976 .
portanto esperemos que o que aconteca e nunca o usarmos e que seja uma heranca a deixar .	so hopefully what happens is you never use it , and it 's an heirloom that you pass down .
e aqui esta o trabalho de equipa outra vez .	so there 's that teamwork thing again .
`` `` '' sou uma pessoa como as outras '' '' . acho a resposta muito elucidativa , pois sugere que os circulos dos altruistas nao tem este aspeto , sao mais assim . ''	`` i 'm just the same as everybody else . '' '' and i think that 's actually a really telling answer , because it suggests that the circles of these altruists do n't look like this , they look more like this . ''
atualmente ha muitas formas de se ser infetado .	now there are many ways you can get infected .
relacionada com isto ha outra questao importante , que sao as lesoes causadas pelas injecoes .	now , related to this is another key issue , which is needlestick injuries .
pouco antes do seu 30º aniversario , em 1958 , yutaka taniyama suicidou-se .	and shortly before his 30th birthday in 1958 , yutaka taniyama killed himself .
tambem seria necessaria uma tremenda quantidade de energia .	these also require tremendous amounts of energy .
( risos ) obrigado .	( laughter ) thank you .
entao , ia a igreja tanto quanto podia .	so i went to church as often as i could .
ca : e durante o ano passado , conte-nos algo promissor que tenha presenciado .	ca : and in the last year , tell us one hopeful thing that you 've seen happening .
e que , por definicao , todos vos aqui neste auditorio tem de se considerar uma alma global , um cidadao global .	and by definition , every one of you who is in this room must consider yourself a global soul , a global citizen .
aquelas sao todas de facto especimes de borboletas verdadeiras .	those are actually all real butterfly specimens .
foi essencial para os avancos no tratamento do vih , nos anos 80 .	that was essential for advancing treatment for hiv in the late 1980s .
e lutar contra eles em campos de batalha contemporaneos .	it 's about fighting them on contemporary battlefields .
o que e que atrai as pessoas aos espacos publicos de sucesso ? o que e que acontece com locais sem sucesso que mantem as pessoas afastadas ?	what attracts people to successful public spaces , and what is it about unsuccessful places that keeps people away ?
agora , como e isso possivel ?	now how is that possible ?
podiamos tentar , mas e um problema de precisao .	it 's like , well , you can try that , but the problem is timing .
lembro-me de um homem idoso que gritava e chorava para que o ajudassemos a levantar-se .	i remembered an old man yelling to us and crying to help us get him up .
mas enquanto as operadoras telefonicas colocaram esta vigilancia como prioridade , as companhias de silicon valley nao .	but while the telephone companies have built surveillance as a priority , silicon valley companies have not .
investidores socialmente motivados . e uma ideia interessante , certo ?	socially motivated investors : there 's an interesting idea , right ?
mas precisamos de abandonar o nosso preconceito em falar sobre coco e chichi para podermos falar calmamente sobre como queremos reutilizar e o que nao queremos reutilizar .	but we need to separate our discomfort about talking about poo and pee so we can calmly talk about how we want to reuse it and what things we do n't want to reuse .
tanisha anderson .	tanisha anderson .
construi uma exposicao interactiva de quimica no museu de ciencia e industria em chicago , e esta exposicao permite que as pessoas usem objectos fisicos para pegar em elementos quimicos da tabela periodica e junta-los para produzir reaccoes quimicas .	i built an interactive chemistry exhibit at the museum of science and industry in chicago , and this exhibit lets people use physical objects to grab chemical elements off of the periodic table and bring them together to cause chemical reactions to happen .
chamamos ao projecto cara-a-cara ( face 2 face ) .	we called the project face 2 face .
eles sabem que eles podem controlar o seu mundo	they know they can control their world .
ca : e , finalmente , esta nova coisa que voce esta a propor nao e uma religiao mas outra coisa , precisa de um lider e voce esta a voluntariar-se para ser o papa ?	ca : and finally , does this new thing that you 're proposing that 's not a religion but something else , does it need a leader , and are you volunteering to be the pope ?
isto e uma pagina 404 .	the 404 page is that .
em 2001 , perguntamos a arabes e a muculmanos em geral , pelo mundo , o que mais admiravam no mundo ocidental .	as early as 2001 , we asked arabs , and muslims in general around the world , what they admired most about the west .
entao , num domingo solarengo , um homem entra na minha cabine de pagamento com uma bela caixa de joias .	so one sunday afternoon , a man walks into my cashier 's booth with this beautiful jewelry box .
o pib tem sido o nosso martelo .	gdp has been our hammer .
sera infeliz ? nao parece ser .	is it miserable ? it does n't seem to be .
aos 88 , ela tinha salvado 12 000 meninas e ela mudou a cultura do pais .	at 88 , she has saved 12,000 girls , and she has changed the culture in the country .
ora nos desistimos da ideia de sermoes .	now we 've given up with the idea of sermons .
e um sistema no qual existem dois tipos de posicoes ... aqueles que fazem erros e aqueles que nao fazem , aqueles que nao conseguem lidar com a privacao de sono e aqueles que conseguem , aqueles que tem maus resultados e aqueles que tem grandes resultados .	it 's a system in which there are two kinds of physicians — those who make mistakes and those who do n't , those who ca n't handle sleep deprivation and those who can , those who have lousy outcomes and those who have great outcomes .
e depois vao querer ficar num abrigo de 48 a 72 horas no minimo , mas vao esperar com esperanca — voces vao ter o pequeno radio de emergencia , e vao ficar a espera que alguem vos diga que e seguro sair la para fora . e isso que precisam de fazer .	and then you want to stay in shelter for 48 to 72 hours minimum , but you 're going to wait hopefully — you 'll have your little wind-up , battery-less radio , and you 'll be waiting for people to tell you when it 's safe to go outside . that 's what you need to do .
90 % dos fundos vieram da tailandia .	90 percent of the funding came from thailand .
portanto pensem no comp . ( registo eletronico e analise de dados )	so think about a cop .
e se nao acreditam em mim , perguntem a vossa operadora movel que informacao guardam sobre vos .	and if you do n't believe me , ask your phone company what information they store about you .
esquecemo-nos de todas as nossas frustracoes de classe media e as dececoes e sentimo-nos como milionarios .	we forget about all of our new middle-class frustrations and disappointments , and we feel like millionaires .
ok. a partir dai vou fazer algo completamente diferente .	okay . from there i 'm going to do a very different thing .
percorremos agora o mesmo caminho que estes artistas primitivos .	you now walk the same path as these early artists .
aqui esta o antes , e aqui esta o depois .	here 's the before , and here 's the after .
e o outro lado com que nos vamos envolver e aquele com quem nos discordamos profundamente .	and the other side which you 're going to engage is the one with whom you profoundly disagree .
a imagem e terrivel , mas rapidamente comecam a perceber que ela nao e real .	the image is terrifying , but you quickly come to understand it 's not real .
aqui esta o allan a ensinar um cirurgiao que fala ingles , em africa , estas habilidades fundamentais basicas necessarias para fazer cirurgias minimamente invasivas .	so here 's allan teaching an english-speaking surgeon in africa these basic fundamental skills necessary to do minimally invasive surgery .
o estado nao esta sozinho . existem muitos , muitos atores .	the state 's not alone . there are many , many actors .
mais uma vez , em testes iniciais , mas avancando para o futuro .	again , in early trials , but moving into the future .
as faculdades e universidades que investem nestes emprestimos securitizados lucram a dobrar .	and colleges and universities that invest in these securitized loans profit twice .
uma rapariga de 16 anos , a conceber uma experiencia de adn que protege a vida de astronautas , pode parecer coisa rara , marca de uma crianca prodigio .	a 16-year-old designing a dna experiment to protect the lives of astronauts may seem like a rarity , the mark of a child genius .
tambem ha limitacoes de tamanho . o cerebro humano tem que caber dentro do cranio , mas um computador pode ser do tamanho de um armazem ou ainda maior .	there are also size limitations , like a human brain has to fit inside a cranium , but a computer can be the size of a warehouse or larger .
o que nos fizemos foi , essencialmente , cancelar a gravidade e controlar o movimento combinando levitacao magnetica e atuacao mecanica e tecnologias de sensibilidade .	what we did was essentially canceling gravity and controlling the movement by combining magnetic levitation and mechanical actuation and sensing technologies .
considero-me uma ativista da saude nacional .	i think of myself as a national health activist .
a psicopatia e um disturbio do desenvolvimento com origens profundamente geneticas , que resulta numa personalidade fria e desinteressada com tendencia para comportamento antissocial e por vezes muito violento .	psychopathy is a developmental disorder with strongly genetic origins , and it results in a personality that 's cold and uncaring and a tendency to engage in antisocial and sometimes very violent behavior .
alguem os escreveu . hem ?	`` `` '' someone wrote them . '' '' hum ? ''
em londres , por exemplo , com estes extraordinarios edificios que tem vindo a aparecer nos ultimos anos .	in london , for example , with these extraordinary buildings that have been appearing over the last few years .
alguns especialistas acham que nao podemos resolver este problema porque nos faltam os conceitos e a inteligencia necessarios .	well , some experts think that we ca n't solve this problem because we lack the necessary concepts and intelligence .
enfim , os idosos nas sociedades tradicionais tem uma importancia enorme que jamais nos ocorreria nas nossas sociedades modernas e alfabetizadas , onde as nossas fontes de informacao sao os livros e a internet .	finally , older people in traditional societies have a huge significance that would never occur to us in our modern , literate societies , where our sources of information are books and the internet .
e eu sugeriria que e tempo de considerar um fundo de inovacao global que encontrasse estes empreendedores por todo o mundo que tem realmente inovacoes , nao so para o seu pais , mas aquelas que pudessemos utilizar tambem no mundo desenvolvido .	and i would submit that it 's time to consider a global innovation fund that would find these entrepreneurs around the world who really have innovations , not only for their country , but ones that we can use in the developed world as well .
querem ver como e ?	here 's what that looks like .
a este ritmo , estaremos nos 9 mil milhoes em 2040 .	at this rate , we 'll reach 9 billion people by 2040 .
e como seria fantastico poder dizer aos vossos netos que fizeram parte disso ?	and how cool would it be to tell your grandchildren that you were part of that ?
ele ensinou-me que a fisica e porreira visto que nos ensina tanto acerca do mundo a nossa volta .	so he taught me that physics is cool because it teaches us so much about the world around us .
e so trabalho , realidade , sangue , suor e nada de lagrimas .	it 's all job , all work , all reality , all blood , all sweat , no tears .
mudaram-se para uma casa perto de um parque .	moved to a house near a park .
80 % do mundo ja come insectos , somos , por isso , uma pequena minoria - num pais como o reino unido , os eua , a holanda , ou outro qualquer .	and then 80 percent of the world already eats insects , so we are just a minority — in a country like the u.k. , the usa , the netherlands , anywhere .
a europa , naquela altura , estava no meio da crise do euro e todas as manchetes eram sobre a desvalorizacao de paises europeus por agencias de notacao financeira nos estados unidos da america .	europe at the time was in the middle of the euro crisis , and all the headlines were about european countries getting downgraded by rating agencies in the united states .
mas o meu projecto preferido foi ha mais de 15 anos , quando fiz parte da equipa que fez o primeirissimo mapa preciso , tridimensional de uma superficie subterranea .	but my very favorite project of all was over 15 years ago , when i was a part of the team that made the very first accurate , three-dimensional map of a subterranean surface .
como podem ver , podemos criar qualquer mundo num computador .	as you can see , we can create any world that we want inside the computer .
jl : eu acho que toda a gente parece gostar mais da amy , ela e como um anjinho perfeito .	jl : i think it feels like everyone seems to like amy more , like she 's the perfect little angel .
criei entao a representacao abstrata disso mas ha muito mais coisas a acontecer abaixo da superficie desta historia , e ha muito mais coisas a acontecer abaixo da superficie do casaco .	so i created this sort of abstract representation of this , but there 's a lot more going on underneath the surface of the story , and there 's more going on underneath the surface of the jacket .
`` ha um filme do realizador canadiano denys arcand — leiam em ingles na pagina , `` '' dennis ar-cand , '' '' se quiserem procura-lo . ''	`` there 's a movie by the canadian film director denys arcand — read out in english on the page , `` '' dennis ar-cand , '' '' if you want to look him up . ''
mais alguma emocao nos ensina a observar com uma intensidade tao peculiar ?	does any other emotion teach us to look with such peculiar intensity ?
e no meio deste musculo , eles encontraram tecidos nervosos , muitos tecidos nervosos , na verdade penetram no musculo , penetram na submucosa , temos todos os elementos do sistema imunitario .	and between this muscle , they found nervous tissues , a lot of nervous tissues , which penetrate actually the muscle — penetrate the submucosa , where you have all the elements for the immune system .
isto e notavel , nao e ?	so this is really remarkable , right ?
`` e isso fez-me lembrar de um `` '' website '' '' do qual eu tinha ouvido falar uns meses antes , chamado change.org . ''	and that got me thinking about a website that i had learned about a few months prior called change.org .
`` `` '' qual e o significado desta nuvem fixa `` '' que paira sempre sobre este pedaco da selva ? ''	what is the significance of this stationary cloud that always hovers over this patch of jungle ?
e nao fazia a menor ideia de que essa pergunta se tornaria na base de tudo o que iria fazer .	and little did i realize that this question would become the basis of everything i would do .
nao ha solucao para a morte .	we ca n't solve for death .
e o hudson n.º 60 e interessante porque alberga cerca de meia duzia de redes importantes , que sao as redes que servem os cabos submarinos , estendidos no fundo do oceano e que ligam a europa e a america , e nos ligam uns aos outros .	and 60 hudson in particular is interesting because it 's home to about a half a dozen very important networks , which are the networks which serve the undersea cables that travel underneath the ocean that connect europe and america and connect all of us .
sim , e barato em termos comparativos .	yeah , it is cheap in comparison .
e isso tem todo o tipo de vantagens .	and that has all sorts of advantages .
nao queremos que eles sejam forcados a emigrar sem estarem preparados para isso .	we do n't want something to happen that they are forced to migrate without having been prepared to do so .
e isto e apenas nos cuidados de saude .	and that 's just in healthcare .
( risos ) a proxima artista e hazel clausen .	( laughter ) the next artist is hazel clausen .
acho que o nosso maior problema e a vontade de partilharmos os nossos dados .	i think the biggest problem that we face is our own willingness to share our data .
portanto , podia escrever esse conjunto de regras que traduzem essa representacao especial para o ingles ,	so i could actually write this set of rules that translates from this particular representation into english .
e lembra-me que , algumas vezes , a melhor forma de encontrar um bom design e apenas lancando-o .	and it reminds me that sometimes the best way to come up with a great design is just to launch it .
e isto acontece muito intensamente ao ponto de , mesmo que oucam falar de revolucoes hoje em dia , estas revolucoes ja nao estao relacionadas com ideologias ou ideias .	and you have this very strongly to the extent that , even if you see when we talk about revolutions these days , these revolutions are not named anymore around ideologies or ideas .
e se o nosso universo for atingido por outro , essa colisao podera gerar um sutil padrao adicional de variacao de temperatura atraves do espaco que nos poderemos um dia estarmos aptos para detectar .	and if our universe got hit by another , that collision would generate an additional subtle pattern of temperature variations across space that we might one day be able to detect .
`` `` '' uktubu '' '' — escreve , no imperativo . ''	`` `` '' uktub , '' '' write , in the imperative . ''
e e isso com que estou a contribuir agora para isto .	and that 's what i 'm now contributing to this .
e verdadeiramente fabulosa .	she 's very fabulous .
no mormonismo , acreditamos que , depois de morrermos , se tivermos mantido todas as regras e seguido todos os rituais , podemos estar juntos como uma familia novamente .	in mormonism , we believe that after you die , if you keep all the rules and you follow all the rituals , you can be together as a family again .
o que fizemos foi quase o que eu chamaria uma versao imatura duma marca de luxo que parecia um emblema num carro de luxo .	and so what we did was almost what i would call an immature version of a luxury brand that looked like a badge on a luxury car .
`` assim , somos informados de que `` '' a minha misericordia engloba todas as coisas '' '' . assim , somos informados de que `` '' a minha misericordia prevalece sobre a minha ira . '' '' que possamos todos receber a graca da misericordia . ''	`` thus we are told that `` '' my mercy encompasses all things . '' '' thus we are told that `` '' my mercy takes precedence over my anger . '' '' may we all be granted a grace of mercy . ''
ha muitas pessoas que me ajudaram na minha vida , e muitas que nao conheci .	there are many people who have helped me in my life , and many that i have n't met .
bem , primeiro ouvimos o que e conhecido como uma negacao nao-contraida .	well first we heard what 's known as a non-contracted denial .
portanto , os precos irao descer para os niveis de hoje , e os custos de utilizacao serao , desde o inicio , muito mais baixos .	so sticker prices will ultimately fall to about the same as today , while the driving cost , even from the start , is very much lower .
mk : bem , este e o cao de assistencia da gabby , o nelson	mk : well , that 's gabby 's service dog nelson .
as salamandras tem a capacidade de se regenerarem .	salamanders have this amazing capacity to regenerate .
consiste em duas partes , a que chamamos um codificador e um transdutor .	so it consists of two parts , what we call an encoder and a transducer .
essas ondas gravitacionais na estrutura do espaco sao totalmente invisiveis , para todos os efeitos .	those gravitational waves in the structure of space are totally invisible for all practical purposes .
vamos comecar a olhar para o que acontece quando a fonte de informacao e desligada , como uma fome ?	are we going to start looking at what happens when your information source is turned off , as a famine ?
quando ouvimos dizer abiola , recordamos eleicoes anuladas e pensamos : esperancas frustradas .	when you hear abiola , you remember annulled elections and you think : dashed hopes .
estamos a dizer a cada unidade se deve virar a direita ou a esquerda .	you 're telling each unit if it should turn right or left .
e realmente uma confluencia do crescimento da populacao urbana , da perda da biodiversidade , e tambem , claro , do aumento dos niveis dos oceanos e das mudancas climaticas .	and it 's really a conflux of urban population rising , biodiversity plummeting and also , of course , sea levels rising and climate changing .
disse-nos para lhe pagarmos , mas nao falavamos ingles .	and he tells us to pay , but we do n't speak english .
portanto , as religioes sao culturas de repeticao .	so religions are cultures of repetition .
aqui , estou a explicar como e que um computador usa a gramatica inglesa para analisar frases , e aqui , ha uma pausa e o aluno tem que reflectir , compreender os conteudos e seleccionar as caixas certas antes de seguir em frente .	here , i 'm explaining how a computer uses the grammar of english to parse sentences , and here , there 's a pause and the student has to reflect , understand what 's going on and check the right boxes before they can continue .
as pessoas que apanhavam infecoes ou se curavam , se tivessem sorte , ou morriam .	people who got infections either recovered , if they were lucky , or they died .
ao reunir os cidadaos , ajudamos a persuadir o nosso governo a fazer o impensavel , a agir e a resolver um problema a milhas de distancia .	by rallying citizens together , we helped persuade our government to do the unthinkable , and act to fix a problem miles outside of our borders .
deem as boas-vindas a nana vasconcelos .	please welcome nana vasconcelos .
os niveis basais sao proximos de zero , sem algum estimulo que provoque a sua libertacao .	baseline levels are near zero , without some stimulus to cause its release .
mas os meus pais nao sabiam que isto estava a acontecer .	but neither of my parents knew this was happening .
o que leva os homens a apoiar o emprego das mulheres e o emprego dos homens , o seu nivel de educacao assim como uma pontuacao elevada do seu pais no indice de desenvolvimento humano das nacoes unidas .	what drives men 's support for women 's employment is men 's employment , their level of education as well as a high score on their country 's u.n. human development index .
por outras palavras , esse risco no quarto de acre tinha de ser reembolsado numa unica colheita . ou eles nao aceitariam o risco .	in other words , that risk on the quarter acre needed to be repaid in a single harvest , or else they would n't take the risk .
esquecemo-nos , mas o modulo lembrava-se .	now , we forgot , but the lander knew .
e a empatia que nos faz ajudar as outras pessoas .	it 's empathy that makes us help other people .
ficam ainda mais chocados com o que ele diz .	they 're even more shocked by what he says .
os jornalistas locais sao os nossos mentores .	our local journalists are our mentors .
agora podem ver um pouco de como tiramos algumas destas fotografias .	now you can also see a little bit how we did some of these shots .
esta tecnologia permite-nos ir mais fundo do que poderiamos ter imaginado sequer ha 10 anos .	this technology enables us to go deeper than we could 've imagined even 10 years ago .
e se , em vez de apenas experimentarem visitar alguma realidade na terra , voces pudessem surfar ondas gravitacionais no limite de um buraco negro , ou pudessem criar galaxias do nada , ou pudessem comunicar uns com os outros sem usar palavras , usando o pensamento ?	what if instead of just experiencing visiting some reality on earth , you could surf gravitational waves on the edge of a black hole , or create galaxies from scratch , or communicate with each other not using words but using our raw thoughts ?
um biliao de pessoas depende do peixe para a sua principal fonte de proteina animal .	a billion people depend on fish for their main source for animal protein .
resultante do medo — — medo de , bem , e se eles falharem ?	and it was out of fear — fear of , well , what if they get it wrong ?
( aplausos ) .	( applause )
se tal suceder , poderemos ter esperanca de que o que vos mostrei com ratos podera tambem funcionar com pessoas .	and if that 's the case , that could give us hope that what i showed you works in mice might also work in humans .
isto e um desenho tecnico de como vigiar uma sociedade , porque sabe-se quem fala com quem , quem envia e-mails a quem ; tudo isto e possivel se tiverem acesso a esta informacao .	this is a blueprint how to survey your society , because you know who talks to whom , who sends whom an email , all this is possible if you have access to this information .
isto claro evita que muitos doentes tenham de fazer viagens longas , arduas , caras e muitas vezes inuteis , ate esses hospitais , e torna-se muito mais provavel que os seus coracoes sejam verificados .	and this of course saves many patients from making long , arduous , expensive and often pointless journeys to those hospitals , and makes it much , much likelier that their hearts will actually be checked .
se , por outro lado , falarem uma lingua sem futuro , falam sobre o presente e o futuro da mesma forma .	if , on the other hand , you speak a futureless language , the present and the future , you speak about them identically .
ele precisava delas para se sentir protegido .	he needed them to feel protected .
`` e estao num restaurante , e dizem , `` '' bem , que idade tens ? '' '' e ela diz , `` '' tenho 60 . '' '' e assim . e nunca iriam adivinhar . ''	`` and you 're in a restaurant , and you say , `` '' well how old are you ? '' '' she says , `` '' i 'm 60 . '' '' that 's what it 's like . and you would never know . ''
entao comecei um projeto de investigacao com eles .	so i started a research project with them .
`` encontrei o `` '' site '' '' do morgan e enviei-lhe uma mensagem , a perguntar se algum dos seus romances espanhois tinham sido traduzidos para ingles . ''	i found morgan 's website and i sent him a message , asking if any of his spanish-language novels had been translated into english .
resume-se apenas a central nuclear de bushehr e a central de enriquecimento de combustiveis de natanz .	it basically boils down to the bushehr nuclear power plant and to the natanz fuel enrichment plant .
no ultimo minuto , vamos ser salvos tal como em todos os filmes de hollywood , tal como no arrebatamento .	at the very last minute , we are going to get saved just like in every hollywood movie , just like in the rapture .
por isso nao importa de onde sao nem que idade tem , e mesmo evocativo .	and it does n't really matter where you 're from or what age you are — it 's really evocative .
`` a cara feia e isto , quando ficamos cara a cara com um cachorro ou crianca , e dizemos : `` '' o que estas a fazer ? para ja com isso , para , para ! '' '' e eu pensei : `` '' oh meu deus , o que e que faco ? '' '' aquela crianca perdeu tudo , uma das duas pessoas em quem ele pode confiar neste mundo puxou-lhe o tapete debaixo dos pes . ''	`` and ugly face is this — when you go face-to-face with a puppy or a child , you say , `` '' what are you doing ! now stop it , stop it , stop it ! '' '' and i went , `` '' oh my god , do i do something ? '' '' that child has lost everything — that one of the two people he can trust in this world has absolutely pulled the rug from under his feet . ''
e alguns dias mais tarde , de regresso a casa apos a lua-de-mel , ele ficou frustrado com o transito e atirou-me com um big mac frio a cara .	and then a few days later , driving home from our honeymoon , he got frustrated by traffic , and he threw a cold big mac in my face .
alterar e retocar e agora uma rotina ,	airbrushing is now routine .
e para alguns centros de dados , pode-se ter estas duas informacoes .	and for some data centers , you might get two of these pieces of information .
somos todos responsaveis .	we all take responsibility in this .
deveria ser mais como a contabilidade privada .	it should be more like private accounting .
muitas pessoas dizem-me que sou fotojornalista , que sou fotografo-antropologo , que sou fotografo-ativista .	many people tell me that you are a photojournalist , that you are an anthropologist photographer , that you are an activist photographer .
`` `` quanto custara ? '' ''	`` `` how much will it cost ? '' ''
num mundo onde mais de dois dias de video sao publicados a cada minuto , apenas aquilo que e verdadeiramente unico e inesperado consegue destacar-se da forma como estes videos se destacaram .	in a world where over two days of video get uploaded every minute , only that which is truly unique and unexpected can stand out in the way that these things have .
ja nao vivemos num mundo em que todas as coisas estao tao nitidamente delineadas , separadas umas das outras .	we no longer live in a world in which everything is as clearly delineated or separated from each other .
`` `` podemos conseguir uma mudanca na sociedade . '' chegou o dia . ''	`` we can bring about change in the society . '' '' the day has come . ''
elas nao surgem na vossa cabeca ?	do n't they just pop into your head ?
esta a aproximar-se mais e mais , e em 20 ..	it 's getting closer and closer , and in 20 ...
podemos ficar zangados com a coisa , as armas nucleares , neste caso , mas e inutil ficarmos zangados com as pessoas .	it 's okay to be angry with the thing — the nuclear weapons in this case — but it is hopeless to be angry with the people .
o que e mesmo importante saber e que os aspectos importantes sao as conversacoes , e nao apenas os modelos em si .	what 's really important to know is that it 's the conversations that are the important aspects , not just the models themselves .
e nunca antes tivemos o luxo de a ter como garantida porque agora e tao barata .	and never before have we had the luxury of taking it for granted because it is now so cheap .
mas vejam isso desta maneira .	but look at it this way .
estamos a centrar-nos no hardware porque e o hardware que pode mudar a vida das pessoas de uma maneira realmente palpavel .	we 're focusing on hardware because it is hardware that can change people 's lives in such tangible material ways .
e acho que percebi porque .	and i think i 've worked out why .
estamos em ramallah .	we 're in ramallah right now .
nao se pode proteger com direitos de autor uma receita por ser um conjunto de instrucoes . sao factos . e nao se pode proteger com direitos de autor o visual e a essencia nem do prato mais original .	you can not copyright a recipe because it 's a set of instructions , it 's fact , and you can not copyright the look and feel of even the most unique dish .
conseguem ver como e que os vossos conhecidos comunicam uns com os outros ; a que horas ligam , quando vao para a cama .	but you can see how your people are communicating with each other , what times they call each other , when they go to bed .
aqui temos raios de bruma .	here we have the fog beams .
quando eu desmontei aquele elefante , sabem qual foi a parte extraordinaria ?	when i came home off that elephant , do you know what the most amazing part was ?
sabem , convenceram-me . estou certo que alguns de vos eram como eu — a ultima e maior das coisas , o palmpilot .	you know , they convinced me . i 'm sure some of you were like me — the latest and greatest thing , the palmpilot .
nos , os pais , temos toda a certeza de que vale a pena .	well , we parents , we parents are pretty sure it 's all worth it .
agora podemos ver o que acontece .	and now we can see what happens .
ele ja pensava que eu era suficientemente louca .	he thought i was mad enough anyway .
os anunciantes acabavam por retirar os seus anuncios .	advertisers would withdraw their advertising .
e preciso nos compreendermos duas coisas muito importantes . primeiro , que querer perceber os tais documentos publicos nao e um capricho , nao e uma curiosidade intelectual .	we need to understand two very important things : first , wanting to understand these public documents is not a whim , is not an intellectual curiosity .
ora bem , ponham-se no lugar dessa mae .	now , put yourself in the shoes of that mom .
e uma doenca que e bastante raro .	this one is a disorder which is quite rare .
`` na sua estrutura de dupla helice , as duas cadeias do adn mantem-se ligadas por uns `` '' degraus '' '' , como um escadote torcido . ''	the two strands of dna , the double-helix structure , are held together by rungs ; it 's like a twisted ladder .
eu tinha cerca de 10 anos e ia acampar com o meu pai nas montanhas adirondack , uma zona selvagem no norte do estado de nova iorque .	i was about 10 years old on a camping trip with my dad in the adirondack mountains , a wilderness area in the northern part of new york state .
sentaram-se a mesa oito entidades .	eight entities came to the table .
uma das primeiras coisas que pensamos que deveriamos abordar seria como conseguiriamos prever as epidemias .	so one of the first things we thought we would tackle would be how we go about predicting epidemics .
que realidade estao a criar para voces mesmos ?	what reality are you creating for yourself ?
alteram os fatos ao seu gosto .	they bend them to their will .
mas isso e um grande problema .	but that is a huge problem .
e depois tambem existem novos desafios , daqueles que nao estamos a espera .	and then there are the new challenges , which we do n't expect .
se olharem para o caso das casas de banho , todas elas apresentam ecossistemas similares , e se olharem para o caso das salas de aula , tambem apresentam ecossistemas similares entre si .	if you look inside the restrooms , they all have really similar ecosystems , and if you were to look inside the classrooms , those also have similar ecosystems .
e outra vez , levou-nos muito tempo a juntar a roda e a mala ...	but then again , it took us a long time to put the wheel and the suitcase together .
vou falar-vos de um trabalho que a minha equipa e eu estamos a fazer na australia , na universidade de queensland , numa tecnologia preparada para resolver esses 4 problemas .	i 'm going to tell you about some work that my team and i are doing in australia at the university of queensland on a technology designed to tackle those four problems .
sou oceanografa quimica .	well , i 'm an ocean chemist .
entao , se estamos mesmo prontos para falar sobre o futuro , talvez devessemos comecar por reconhecer que estamos a ficar sem tempo .	so if we 're really ready to talk about the future , perhaps we should begin by admitting that we 're out of time .
nos , por outro lado , temos escolha .	we , on the other hand , do have a choice .
`` elas nao vivem a experiencia das amarras como nos a viveriamos . '' '' nao tive coragem de lhe dizer naquele momento que nao , nao somos assim tao diferentes dele . ''	`` they would n't experience restraints as we would . '' '' i did n't have the courage to tell him in that moment that , no , we 're not that different from him . ''
o gratis e algo que vem com o digital , porque os custos de reproducao sao essencialmente gratis . chega com o ip , porque e um protocolo tao eficiente . chega com a fibra optica porque permite muita largura de banda .	free is something that comes with digital , because the reproduction costs are essentially free . it comes with ip , because it 's such an efficient protocol . it comes with fiber optics , because there 's so much bandwidth .
e no inicio , muito poucas pessoas estao afectadas , e obtemos esta curva sigmoide , ou em forma de s .	and at the very beginning , not too many people are affected , and you get this classic sigmoidal , or s-shaped , curve .
e a grande arte teria cabeca : teria ideias intelectuais interessantes e conceitos .	`` and great art would have `` '' head '' '' : it would have interesting intellectual ideas and concepts . ''
e vejam aqui quando eu vos levo para os meus graficos de bolas .	and look here when i take you into my bubble graphs .
como e que hipomenes a venceu ?	how did hippomenes beat her ?
uma coisa ligeiramente tola , que e invisivel e esta historia , que e invisivel , para voces .	one slightly silly thing that 's invisible is this story , which is invisible to you .
a nossa mae tambem .	and so did our mother .
entao , os meus dentes na verdade mantiveram o meu maxilar inferior na posicao correta .	so my teeth actually hold my jaw in the correct position .
entao , sei que fui super rapido . se vos escapou alguma coisa ,	so i know i went super fast .
criamos uma reacao emocional a estas formas .	we created an emotional reaction to these forms .
uma das melhores maneiras de matar mosquitos , e nao os deixar chegar a adultos para andarem por ai a voar a picar pessoas e a transmitir doencas .	one of the best ways of killing mosquitos is not to wait until they fly around like adults and bite people and transmit disease .
eles tem a samsung , como podem ser um pais em desenvolvimento ?	they get samsung , how can they be [ a ] developing country ?
era uma ficcao criada pelos meus medos , mas eu acreditava nela .	this was a fiction born of my fears , but i believed it .
( aplausos ) se processarmos as mesmas duas imagens de forma diferente , conseguimos mesmo ver-nos livres do texto do livro de oracoes .	( applause ) if you process the same two images in a different way , you can actually get rid of the prayer book text .
todas estas centrais de carvao ja existentes fecharam .	all of these existing coal plants were retired .
responsabilidade .	accountability .
mas , e se fosse verdadeira ?	but what if there was something to it ?
naquela epoca , estas palavras estavam destinadas a atingir os britanicos , mas nos ultimos 200 anos , elas encarnam o que muitos ocidentais acreditam , que a liberdade e o bem mais valioso e que os melhores sistemas politicos e economicos tem a liberdade como parte integrante .	at the time , these words were earmarked and targeted against the british , but over the last 200 years , they 've come to embody what many westerners believe , that freedom is the most cherished value , and that the best systems of politics and economics have freedom embedded in them .
nao se pode fugir do sofrimento nem encontrar o sentido .	you ca n't buy your way out of suffering or into meaning .
`` seria um `` '' chip '' '' personalizado a sua medida . ''	it would be a personalized chip just for you .
no entanto , ao longo dos cinco anos seguintes ela voltava nos meses de inverno .	and yet , for the next five years she returned in the winter months .
mais recentemente temos estudado as resinas que as abelhas recolhem das plantas .	and more recently , we 've been studying resins that bees collect from plants .
entao , se somos nos os donos dos mercados de capitais , porque nao conseguimos sermos ouvidos ?	so if we are the ultimate owners of the capital markets , why are n't we able to make our voices heard ?
`` a pior mensagem que ja recebemos dizia exatamente o seguinte : `` '' ele nao deixa de me violar . ''	`` and the worst message we ever got said exactly this : `` '' he wo n't stop raping me . ''
sao sobre onde moramos , com quantas pessoas vivemos , se somos donos ou nao das nossas casas .	they 're about where you live , how many people you live with , and whether you own your home or not .
temos entao uma especie de dupla natureza .	so we have this kind of dual nature .
tambem aprendi como o lixo e implacavel .	i also learned about the relentlessness of trash .
continuo a pensar nestes rapazes sem bracos .	i keep thinking about these kids with no arms .
nos ainda gostamos de consumir , claro .	we still like to consume , of course .
parece que parei o programa .	it looks like i 've paused the program .
existem arquitectos e construtores de cidades bastante interessados .	there 's designers and builders of cities who are very interested .
mas isto nao e so sobre como sobreviver no papel duplo de ter uma carreira e ser mae .	but this is not just about surviving in your dual role as a career woman and mother .
acontece que esta gera alguma mudanca , mas nao muita .	it turns out , it does a little , but not a lot .
( aplausos )	( applause )
isto e uma morte na estrada .	this is roadkill .
por vezes , reparava que nao conseguia desenhar o lado direito de um circulo .	sometimes i would find that i could n't draw the right side of a circle .
( risos ) mas esperem , este e o meu projeto favorito .	( laughter ) but wait , this is actually my favorite project .
mk : ela foi quem mais apoiou a minha carreira . e sabia que era a coisa certa a fazer .	mk : she was the biggest supporter of my career , and i knew it was the right thing to do .
quantos aqui conseguiram passar em anatomia ?	how many of you here made it through anatomy ?
e em seattle , pega-se nisto — isto e um hemisferio humano inteiro — e colocamo-lo dentro do que e basicamente um cortador de carne chique .	and in seattle , we take these — this is a whole human hemisphere — and we put them into what 's basically a glorified meat slicer .
entao era esse o seu sonho , de certo modo , desde jovem ?	so that was a dream of yours , in a way , from a young age ?
todos precisamos de pessoas que nos avaliem .	we all need people who will give us feedback .
bom , nesse caso , talvez nao precisemos de guardar rancor da excelencia de alguem .	well , maybe then we would n't have to resent somebody 's excellence .
isto nao e apenas uma coisa boa . eu acho que e um imperativo social .	`` and this is n't even just a `` '' nice to have . '' '' i think it 's a social imperative . ''
quando olho para a minha cidade destruida , e claro , pergunto-me : o que levou a esta guerra sem sentido ?	when i look at my destroyed city , of course , i ask myself : what has led to this senseless war ?
assustados , tambem , pelas rixas e brutalidades .	they were scared from all the fighting and all the bullying .
e tambem a ideia da fachada era muito mais barata , nao so devido ao material , em comparacao com o vidro , mas tambem porque nao precisariamos de ter ar condicionado .	and also that the idea of the facade was much , much cheaper , not only because of the material compared with the glass , but also because we did n't need to have air conditioning anymore .
sim , os criminosos informaticos tambem fazem festas de natal , como se mostra .	that 's right , cybercriminals do have christmas parties , as it turns out .
a inveja [ e o ciume ] gostam de detalhes .	jealousy likes details .
essa e uma combinacao mais significativa , muito mais poderosa .	that 's a much more meaningful combination , a more powerful combination .
ou sera que depende do observador ?	or is it observer-relative ?
os sintomas do complexo sao que , independentemente da complexidade do problema , a pessoa tem uma crenca absolutamente inabalavel que a sua solucao e infalivelmente certa .	so the symptoms of the complex are , no matter how complicated the problem , you have an absolutely overwhelming belief that you are infallibly right in your solution .
e no meu 17.º aniversario , depois do meu fingido exame aos olhos , o oftalmologista apercebeu-se que era o meu dia de anos ,	and on my seventeenth birthday , after my fake eye exam , the eye specialist just noticed it happened to be my birthday .
desta forma , com o metodo comum , as celulas disparam , mas nao segundo os padroes normais , porque nao tem o codigo certo .	and so with the standard method , the cells do fire , they just do n't fire in the normal firing patterns because they do n't have the right code .
e disso que precisaremos a medida que formos avancando de sonhar e imaginar o que ira ser mesmo necessario para construir uma economia global que inclua todos nos . e finalmente estender essa proposicao fundamental de que todos os homens sao criados igualmente , a todos os seres humanos do planeta .	for that is what we 'll need , as we move forward to dream and imagine what it will really take to build a global economy that includes all of us , and to finally extend that fundamental proposition that all men are created equal to every human being on the planet .
foram retirados ipsis verbis das declaracoes da propria palin .	they were lifted verbatim from palin 's own remarks .
entao , num dia , um dia tipico ensolarado na amazonia , uma arvore grande chega a transferir mil litros de agua atraves da evaporacao . mil litros .	so , in a typical sunny day in the amazon , a big tree manages to transfer 1,000 liters of water through its transpiration — 1,000 liters .
funcionavam das 10h as 3h . fechavam a hora de almoco .	they operated 10 to 3. they were closed for lunch hour .
dm : eu estou a sugerir que temos de ter uma mente aberta .	dm : i 'm suggesting we have to be open-minded .
nao fez eletrificacao rural .	it did n't do rural electrification .
`` `` '' nao , general . nao pode pagar-me . tenho sido pago . ''	`` `` '' no , general . you ca n't pay me . i 've been paid . ''
nao , nao estou a mostrar nenhumas imagens , porque os buracos negros nao deixam para tras trilhos uteis de tinta , e o espaco nao e pintado , mostrando-vos as curvas .	no , i 'm not showing you any images , because black holes do n't leave behind helpful trails of ink , and space is not painted , showing you the curves .
realmente esta bastante ocupado .	it 's actually pretty busy .
estamos tambem a obter , claro , muitos lolcats .	we 're also getting , of course , a lot of lolcats .
novas particulas podem aparecer imediatamente como bossas grandes e obvias , ou podem-se revelar depois de anos de aquisicao de dados .	new particles can either show up immediately as big , obvious-to-spot bumps , or they can only reveal themselves after years of data taking .
e a cena repete-se tantas vezes .	and the scene repeats itself so often .
todas estas informacoes sao obrigatorias . a lingua chinesa nao me deixa ignora-las .	all of this information is obligatory . chinese does n't let me ignore it .
aprendi que o meu lugar nao e so no ocidente ou em africa e que ainda estou a procura da minha identidade , mas vi o gana criar uma melhor democracia .	now i have learned that my place is not just in the west or in africa , and i 'm still searching for my identity , but i saw ghana create democracy better .
se alguma coisa matar mais de 10 milhoes de pessoas nas proximas decadas , e muito mais provavel dever-se a um virus altamente contagioso do que a uma guerra .	if anything kills over 10 million people in the next few decades , it 's most likely to be a highly infectious virus rather than a war .
colaborador : senti-me realmente triste quando ele morreu .	collaborator : i felt really sad when he died .
isto ja esta a comecar a acontecer na africa subsariana .	this is already beginning to happen in sub-saharan africa .
ou seja , quantos anos viveram .	so , how many years they lived .
pode parecer futil , mas nao e .	it might seem frivolous , but it 's not .
nao havia agua . nao havia energia , petroleo , carros , nada disso .	there was no water . there was no energy , no oil , no cars , none of that .
e uma forma antiga do livro e o rolo de pergaminho .	and one ancient form of the book is scrolls .
`` e depois : `` '' quem nao podia pagar ? '' '' `` `` eu nao podia pagar . '' '' ''	so who could n't pay ? i could n't pay .
pode nao ser o que queres escutar em casa , mas funciona muito bem no carro — tem uma enorme gama de frequencias , sabes , um grande baixo e alta qualidade e a voz como agarrada no meio .	it might not be what you want to listen to at home , but it works great in the car — has a huge frequency spectrum , you know , big bass and high-end and the voice kind of stuck in the middle .
nao e um codigo muito complicado .	it 's not very complicated code .
entao , vao fazer o primeiro solo que fizemos , sim bla bla bla bla , entramos no dueto , sim , bla bla bla bla . o proximo solo , bla bla bla bla , sim , e os dois ao mesmo tempo . fazes as ultimas solucoes .	so , you 're going to do the first solo that we made , yeah blah blah blah blah , we go into the duet , yeah , blah blah blah blah . the next solo , blah blah blah blah , yeah , and both at the same time , you do the last solutions .
( risos ) as galaxias , estimadas em 100 bilioes , no universo .	( laughter ) galaxies , 100 billion of them estimated in the universe .
quanto a mama , os nossos resultados sao melhores do que os cirurgicos .	and we have better-than-surgery results in breasts .
mais uma vez e util fazer uma analogia entre a leitura e a escrita .	again , it 's useful to make an analogy to reading and writing .
e isto deu a einstein um grande destaque em todo o mundo .	and this gained einstein prominence around the world .
e porque e que fizemos essas experiencias ?	why did we set up these experiments ?
ficavam ali ate que , a certa altura , a prisao estava a transbordar e eles queriam meter mais alguem .	you 'd stay until , at some point , the jail would be booked to capacity , and they 'd want to book someone new in .
portanto , as estatisticas sao a nossa vida em grupo , nao como pessoas individuais .	so statistics are about us as a group , not us as individuals .
na faculdade , era uma remadora de mao cheia e ate competiu por um lugar na equipa olimpica dos eua , de 1992 mas isto era diferente .	she was an accomplished rower in college , even competed for a spot on the 1992 u.s. olympic team , but this , this was different .
ha algo que existe quando nao estamos a olhar , mas nao e o espaco-tempo nem os objetos fisicos .	there 's something that exists when you do n't look , but it 's not spacetime and physical objects .
okay . quem aqui nao da nada por eles ?	okay . who here , it does nothing for them ?
`` no teatro , a faca nao e uma faca e o sangue e apenas `` '' ketchup '' '' . ''	in the theater , the knife is not a knife and the blood is just ketchup .
os programas de proteccao civil estavam desligados da realidade do que assistiriamos numa guerra nuclear total .	the civil defense programs were disconnected from the reality of what we 'd see in all-out nuclear war .
nesta epoca , em que tudo parece estar desenhado , medido e estudado , nesta epoca da informacao , recordo-vos que as descobertas nao sao feitas no buraco negro do desconhecido mas no ruido branco de dados esmagadores .	and in this age , where everything seems mapped , measured and studied , in this age of information , i remind you all that discoveries are not just made in the black void of the unknown but in the white noise of overwhelming data .
`` mas tambem imaginavam , algumas vezes : `` serei um verdadeiro pai ? '' ''	but they also sometimes wondered : am i a real parent ?
entao , o que fazer ?	so , what to do ?
e por isso , quis que a capa deste livro fosse uma deturpacao de si propria e que de alguma forma mostrasse a reacao do leitor a isso .	and so i wanted the cover of this book to also misrepresent itself and then somehow show a reader reacting to it .
mt : a sua grande ideia era a corrente alternada .	mt : his great idea was alternating current .
e dificil para as pessoas deixarem mas impressoes .	it 's hard for people to leave bad reviews .
todos dizem que as baterias sao muito caras .	everybody tells us batteries are so expensive .
imaginem o efeito da luz das velas naquela superficie ,	imagine that effect of candlelight on that surface .
estamos todos aqui , e todos aqueles que assistiram ficarao traumatizados por este evento , mas todos voces que sao vitimas vao aprender algumas verdades dolorosas .	we 're all here , and all of those who watch it are going to be traumatized by this event , but all of you here who are victims are going to learn some hard truths .
o envio de sms e representado significativamente na juventude de grupos minoritarios e urbanos .	texting actually overindexes for minority and urban youth .
e isto leva-me a minha modesta proposta .	and this brings me to my modest proposal .
mas quando a politica e sobre nos , os nossos vizinhos e as pessoas na nossa comunidade , juntos na criacao de experiencias de voz coletiva e imaginacao , comecamos a lembrar-nos de que isto importa .	but when politics is about us and our neighbors and other people in our community coming together to create experiences of collective voice and imagination , then we begin to remember that this stuff matters .
tem sido uma experiencia incrivel .	and it 's been an incredible experience .
o especial foi a forma da abordagem deles .	what was special was their approach .
sabemos que utilizaremos eletricidade daqui a 20 ou 30 anos .	we know we 'll use electricity in 20 or 30 years ' time .
mas eles nao estavam a perceber isso .	and so they still were n't getting it .
e adoro cavar um buraco .	and i love to dig a hole .
`` `` nao . esse corpo esta desfeito . ja nao me serve para nada . '' ''	`` `` no . that body is broken . it can no longer serve me . '' ''
poderia deliciar-vos com historias de ignorancia atraves de decadas de experiencia como perito forense em simplesmente tentar levar a ciencia a sala do tribunal .	i could regale you with horror stories of ignorance over decades of experience as a forensic expert of just trying to get science into the courtroom .
durante um ano , uma central pode fornecer energia 92 % do tempo .	during a year , a single plant can provide power 92 percent of the time .
qual a diferenca entre ambos ?	what 's the difference between those ?
penso que e provavelmente uma das tendencias tecnologicas mais importantes que estamos a ver hoje .	and i think that 's probably one of the most important technology trends that we 're looking at today .
isto sao casas de banho composto . e ninguem na escola queria ouvir falar delas , especialmente o reitor .	these are compost toilets , and nobody at the school wanted to know about them , especially the principal .
18 cabecas , 18 corpos , 18 misterios .	18 heads , 18 bodies , 18 mysteries .
porque e que nao havia uma forma legal de ela estudar na europa ?	why was n't there a legal way for her to study in europe ?
mas a maioria dos estranhos nao sao perigosos .	but most strangers are n't dangerous .
( risos ) no final do curso , os estudantes obtiveram um certificado .	( laughter ) at the end of the course , the students got a certificate .
como muitos de voces sabem , os individuos que sofrem de tdah tambem tem dificuldades de aprendizagem .	as many of you know , individuals afflicted with adhd also have learning disabilities .
e 20 vezes o central park .	that 's 20 central parks .
mas , onde ha uma crise , tambem ha oportunidades .	but where there is crisis , there is also opportunity .
e tambem a historia do capitalismo moderno . porque foi da riqueza desta terra que surgiu o nosso sistema economico , um sistema que nao pode sobreviver sem crescimento perpetuo e um fornecimento sem fim de novas fronteiras .	and it 's also the story of modern capitalism , because it was the wealth from this land that gave birth to our economic system , one that can not survive without perpetual growth and an unending supply of new frontiers .
comecamos ... por pensar que a agua e como o sangue .	we 'll start by thinking that water is like blood .
esta e a sua caligrafia na manha do tratamento antes do procedimento na rm . agora vou-vos mostrar como e um procedimento padrao , como e uma cirurgia nao invasiva .	this is his handwriting on the morning of the treatment before going into the mr so now i 'll take you through [ what ] a typical procedure like that looks like , [ what ] noninvasive surgery looks like .
entao eu posso analisar o que eu ja fiz em determinadas alturas .	so i can drill into what i 've done over specific time frames .
se comprimirem a materia , a temperatura sobe .	if you squeeze things together , the temperature goes up .
o objectivo e ser uma cidade milenar como muitas outras : istambul , roma , londres , paris , damasco , cairo .	our objective is to be a millennium city , just like many millennium cities around : istanbul , rome , london , paris , damascus , cairo .
primeiro , que ensinar cirurgia e fazer cirurgia e mesmo dificil .	number one : teaching surgery and doing surgery is really hard .
por isso estas pessoas eram absolutamente fundamentais .	so these guys were absolutely crucial .
nos compramos , vendemos , espalhamos e fazemos a guerra .	we buy it , sell it , spread it and wage it .
depois de escalar uma colina ingreme e de limpar o suor da testa , descreveu o que viu , abaixo dele .	after climbing a steep hill and wiping the sweat from his brow , he described what he saw beneath him .
`` para as marcas , os `` '' malucos por tenis '' '' sao uma populacao importante . ''	for the brands , sneakerheads are a very important demographic .
e se existisse um meio nativo para o valor ?	what if there were a native medium for value ?
eu agarrei-me a isto como gato a bofe .	i took to this like a duck to water .
e quase do tamanho da franca , mas sofre de muitas das barreiras principais existentes no mundo das vacinas atuais .	it 's about the same size as france , but it suffers from many of the key barriers existing within the world of today 's vaccines .
talvez pareca uma contramedida pequenissima para um grande , um enorme problema — vamos la plantar flores — mas quando as abelhas tem acesso a uma boa alimentacao , nos temos acesso a uma boa alimentacao atraves dos seus servicos de polinizacao .	so maybe it seems like a really small countermeasure to a big , huge problem — just go plant flowers — but when bees have access to good nutrition , we have access to good nutrition through their pollination services .
tenho um lapis que te posso emprestar .	i got a pencil you can borrow .
no cenario de boltzmann , se se quer fazer uma tarte de maca , e so esperar pelo movimento aleatorio de atomos que nos facam uma tarte de maca .	in boltzmann 's scenario , if you want to make an apple pie , you just wait for the random motion of atoms to make you an apple pie .
gratuitamente .	for free .
primeiro , o que e isso ?	first off , what is it ?
penso que esta e a ciencia mais fixe possivel .	i think this is the coolest possible science .
a agricultura de subsistencia esta a acabar .	subsistence farming is drying up basically .
o que implica esta compaixao ?	what does this compassion entail ?
e nao sou a primeira pessoa a interrogar-se .	and i 'm not the first person to ask this question .
tambem temos uma fundacao comprometida em trabalhar atraves de parceiros e ajudar a melhorar as vidas e proteger os direitos de 100 milhoes de criancas ate 2015 .	we also have a foundation that 's committed to work through partners and help improve the lives and protect the rights of 100 million children by 2015 .
ao motivar as pessoas a amar e a defender o mundo natural , um quilograma de esperanca vale uma tonelada de desespero .	in motivating people to love and defend the natural world , an ounce of hope is worth a ton of despair .
e isso fascinou-me , porque passei a maior parte da minha vida a volta de uma camara .	and that fascinated me , because i 'd been messing around with a camera most of my life .
e se a tv estivesse ligada , estavamos a ver um documentario .	and if the tv was on , we were watching a documentary .
o indice de propriedade imobiliaria e o menor desde 1995 .	home-ownership rates are at their lowest since 1995 .
os insectos sao animais que andam sobre seis patas .	insects are animals that walk around on six legs .
apenas por me dar as chaves do seu carro o meu irmao foi detido duas vezes e ele foi assediado a tal ponto que teve de desistir do seu trabalho como geologo deixar o pais com a sua esposa e o filho de dois anos .	just for giving me his car keys , my own brother was detained twice , and he was harassed to the point he had to quit his job as a geologist , leave the country with his wife and two-year-old son .
mas a terra e muito , muito velha .	but the earth is very , very old .
e e um pouco ironico que comecamos a romper com o sistema educativo tradicional , e com isso , acabamos por fazer da nossa aula online mais uma aula universitaria tradicional do que outras aulas online .	and it 's a little bit ironic that we set about to disrupt traditional education , and in doing so , we ended up making our online class much more like a traditional college class than other online classes .
daqui a alguns anos , estarao em muitos dos objetos e tecnologias que usamos diariamente .	in a few years , they will be in many of the objects and technologies we use on a daily basis .
vamos voltar a questao do nosso diretor .	let 's come back to our tech ceo 's question .
ha 100 % de estrela de anis naquilo .	there 's 100 percent star anise in there .
nada poderia ser menos materialista , ou mais sentimental , do que um adolescente comprar umas calcas de ganga novas e rasga-las ate ao joelhos , porque ele quer agradar a jennifer .	nothing could be less materialistic , or more sentimental , than a teenager buying brand new jeans and tearing them at the knees , because he wants to please jennifer .
diz claramente para o que e o medicamento , especificamente para quem e benefico , portanto podemos comecar a personalizar o nosso entendimento se a informacao e relevante para voces ou se o medicamento e relevante para voces .	it says very clearly what the drug is for , specifically who it is good for , so you can start to personalize your understanding of whether the information is relevant to you or whether the drug is relevant to you .
mas , depois de acabar a faculdade , e de ter o diploma na mao , encontrei-me a passar de um emprego menos ideal para outro .	but after i graduated from college and got a graduate degree , i found myself moving from one less ideal job to another .
uma corrente de agua refrescante , poderao dizer .	a cool and refreshing stream of water , you say .
isso esta absolutamente certo para que as pessoas sigam os seus interesses .	that 's absolutely the right thing , for people to follow their self-interest .
as iniciais significavam programacao logica para automacao de operacoes de ensino .	the initials stood for programmed logic for automated teaching operations .
seria fantastico .	that would be awesome .
a tecnologia e transformadora .	technology is transformational .
tem esta missao : mudar a forma como a comunicacao publica e feita .	it has this mission : to change the way how public communication is made .
portanto , se o que nos queremos e justica , entao acho que nao nos devemos focar na imprensa ou em contadores de historias .	and so if it is justice that we are after , then i think we must n't focus on the media or on storytellers .
e eu lembrei-me de um sujeito velho e bebado veio um dia ao laboratorio esperando fazer algum dinheiro facil e este era o tal pessoa .	and i remembered that the old and drunken guy came one day to the lab wanting to make some easy cash and this was the guy .
nao estou a tentar passar uma mensagem niilista ,	now i 'm not trying to deliver a nihilistic message here .
entao olhando para coisas como aglomerados de galaxias , e como elas — a sua densidade numerica , quantas existem como funcao do tempo — podemos aprender como esta materia escura e energia escura competem entre elas na formacao de estruturas .	so by looking at things like clusters of galaxies , and how they — their number density , how many there are as a function of time — we can learn about how dark matter and dark energy compete against each other in structure forming .
muito obrigada .	thank you very much .
vemos aqui um ferimento de bala na nuca ou uma ferida de catana , por exemplo .	so here you see a gunshot wound to the back of the head or a machete wound , for example .
por isso , temos um problema .	so we have a problem .
sao bastante quebradicas . pelo que aqui apenas esta parte de uma .	they are quite brittle . so you 've only got a part of one there .
`` `` '' na verdade , a materia viva parece comportar-se numa ordem , numa estrutura , `` '' semelhante a da materia inanimada quando perto do zero absoluto , `` '' onde os efeitos quanticos desempenham um papel muito importante . ''	in fact , living matter seems to behave in this order , in a structure , just like inanimate matter cooled down to near absolute zero , where quantum effects play a very important role .
e um hotel que apenas se encontra aberto ate a meia-noite , logo nao e um sitio onde se possa pernoitar .	it 's a hotel that 's only open until midnight , so it 's not a place that you stay .
e quando sou reconhecido , e um bocado como um sabe-tudo .	and when i do , it 's as a bit of a know-it-all .
eu nao poderia salvar o mundo ; ninguem pode .	i mean , i ca n't save the world . nobody can .
( risos ) novembro de 2005 : as ruas estao a arder .	( laughter ) november 2005 : the streets are burning .
como era adolescente , culpava-me por tudo o que tinha acontecido .	as a teenager , i was blaming myself for everything that happened .
ninguem sabe quem ou o que ele e .	no one knows who or what he is .
obrigado .	thank you .
se os especialistas descobrem qualquer problema , e recomendado um tratamentos apropriado .	and if any problems are spotted by the specialists there , a suitable course of treatment is recommended .
e nao so da mais poder as comunidades , mas mais importante , esta informacao fica na comunidade onde e necessaria para formular politicas de saude a longo-termo .	and not only is it empowering to the communities , but really importantly , this information stays in the community where it is needed to formulate long-term health polices .
mas nao estamos aqui para contar historias , pois nao ?	but we are not here to tell stories , are we ?
para mim , as palavras sao mais como instintos e linguagem .	to me , words are more like instincts and language .
mas queriamos estabelecer o caso economico , porque se pudermos estabelecer o caso economico , entao o valor desta acao seria extremamente recompensador .	but we wanted to make the economic case , because if we could make the economic case , then the value of doing this would be completely compelling .
penso que um grande exemplo disto e o novo programa de expansao de saude da etiopia .	i think a great example of this is ethiopia 's new health extension program .
um destes e raspadinhas de obras-primas .	one of these is scratch-off masterpieces .
muitas pessoas diriam : bem , e muito facil .	many people would say , well , that 's very easy .
e esta a sua relevancia no que diz respeito a conversa sobre o ambiente .	this is their kind of resonance for the conversation around the environment .
ele nao estava ali para matar , ou para mutilar a gill hicks .	he did n't set out to kill or maim me , gill hicks .
foram espezinhadas ate a morte .	they have been stomped to death .
isto aconteceu perto do natal .	this happened around christmas .
ha algo em mim que se solta .	something in me loosens .
desde nao ter valvulas de travagem ate a total recuperacao — cinco dias .	from having no braking valves to complete recovery in five days .
fazer testes e stressante , mas marcar respostas multiplas numa folha de teste nao impede que as balas estourem .	taking tests is stressful , but bubbling in a scantron does not stop bullets from bursting .
entao abordamos os partidos politicos tradicionais , oferecemos-lhes o democracyos e dissemos :	so we reached out to traditional political parties and we offered them democracyos .
normalmente , pensa-se que e uma emocao que vem por piedade .	often it 's thought that that 's an emotion that comes up out of pity .
o que e que quero dizer por bem suportados ?	now , what do i mean by well motivated ?
e custa 855 milhoes de dolares	it cost 855 million dollars .
aparentemente , ocorre muita apofenia no nosso hemisferio direito .	our right hemisphere appears to be where a lot of this patternicity occurs .
entao , e realmente o terrorismo que estamos a evitar ?	so is it really terrorism that we 're stopping ?
temos numeros locais acessiveis a ¾ de mil milhoes de pessoas no planeta .	we have local numbers accessible to three quarters of a billion people on the planet .
e por isso que estamos a mudar a nossa percepcao sobre os insectos .	that 's why we 're changing the perception of insects .
mas existem programas excelentes para adolescentes que estao no limiar do acolhimento e 30 % das criancas que vao para o acolhimento sao adolescentes .	but there are great programs for adolescents who are on the edge of care , and 30 percent of kids going into care are adolescents .
mas eu continuei a sonhar .	but i kept dreaming .
por que nao apoiamos o processo da maior tregua global ?	why do n't you support the process of the largest ever global truce ?
estao tentar trazer ordem ao caos .	they 're attempting to bring order to chaos .
mas talvez o exemplo mais surpreendente de como as pessoas estavam empenhadas em ajudar-me a ler o mundo , tenha surgido ja no final da minha jornada , quando tentei encontrar um livro da pequena e lusofona ilha africana de sao tome e principe .	but perhaps the most amazing example of the lengths that people were prepared to go to to help me read the world , came towards the end of my quest , when i tried to get hold of a book from the tiny , portuguese-speaking african island nation of sao tome and principe .
os nossos esgotos estao-se a desfazer .	our sewers are crumbling .
`` ele desenha muito bem paus . '' '' ( risos ) o que foi um dos melhores elogios de sempre . ''	`` he draws sticks real good . '' '' ( laughter ) which is one of the best compliments ever . ''
e mais co2 do que a cidade de nova iorque gera num ano .	that is more co2 than what the entire city of new york generates in one year .
esta como que a surfar num campo magnetico na crista de uma onda .	it 's sort of surfing on a magnetic field at the crest of a wave .
ha uma excecao , e e uma curiosidade : e o quadrilatero que vai de cuiaba a buenos aires , de sao paulo aos andes .	there is an exception , and it 's curious : it 's the quadrangle that ranges from cuiaba to buenos aires , and from sao paulo to the andes .
e depois se analisarmos corais mais proximos dos dias de hoje , ou se mergulharmos ate la hoje e medirmos a quimica dos corais , vemos que passamos para uma posicao na qual pode haver trocas de carbono .	and then if we analyze corals closer to the modern day , or indeed if we go down there today anyway and measure the chemistry of the corals , we see that we move to a position where carbon can exchange in and out .
e enorme , tem o tamanho de um frigorifico .	it 's huge .
quando finalmente consegui abrir os olhos , consegui registar este momento .	by the time i managed to open my eyes , i had documented this moment .
sao coisas que as minhas criancas nao tem .	these are things my kids do n't get .
mas nao queremos um problema qualquer , queremos os mais dificeis que podemos encontrar , queremos aquele que , se for resolvido , tem um ligeiro fator de estupefacao .	but we do n't want just any math problem , we want the hardest ones that we can possibly find , and we want the one that if you solve it , there 's a little bit of a wow factor .
e , portanto , se eu vos fosse dar o final desta historia , seria qualquer coisa como isto : e foi isso que , em ultima analise , me levou a falar para vos , aqui na ted , sobre a historia .	and so if i were going to give you the ending of this story , it would go something like this : and that 's what ultimately led me to speaking to you here at ted about story .
podemos fazer imensas coisas com o material .	we can do a lot of things with the material .
nascera no campo rashidieh para refugiados palestinos que e onde ainda vive .	he was born in the rashidieh camp for palestinian refugees , and this is where he still lives .
quais seriam os produtos deste novo tipo de agricultura ?	and what would be the products of this new type of agriculture ?
obrigado .	thank you .
`` o investigador brene brown disse , e eu cito : `` '' a vergonha nao sobrevive a empatia '' '' . ''	`` researcher brene brown said , and i quote , `` shame ca n't survive empathy . '' ''
deixem-me dar-vos um exemplo muito recente , como talvez , na semana passada .	let me give you a very recent example , as in , like , last week .
o simbolo da porta parece-se com duas portas de um saloon do faroeste .	the symbol of the door looks like a pair of saloon doors in the wild west .
esta zona com a forma de um copo e o que chamamos a zona optima .	that horn-shaped region is what we call the sweet spot .
olhem para o mundo .	look at the world .
e entao estas mentiras estao a ser usadas por pessoas para criar uma reserva , como o mordomo costumava fazer , entre nos e as ligacoes com todas as outras pessoas .	and so these lies are being used by people to create a buffer , like the butler used to do , between us and the connections to everybody else .
sera muito mais facil se passarmos de carne , de carne de vaca , a insectos .	we could much better change from meat , from beef , to insects .
e na verdade , se compararmos isso com os dados , encaixa muito bem com o desenvolvimento das cidades e das economias .	and in fact , if you compare it to data , it fits very well with the development of cities and economies .
todos : eu sou mais do que os meus genes .	everybody : i am more than my genes .
levei-o a empresa do paul maccready , a aerovironment para um estudo de viabilidade , e eles analisaram-no , e tiveram uma serie de ideias inovadoras sobre a sua propulsao .	i brought it to paul maccready 's company aerovironment to do a feasibility study , and they analyzed it , and came up with a lot of innovative ideas about how to propel it .
a crise economica global reacendeu o interesse publico naquela que e talvez uma das questoes mais antigas em economia , que remonta a , pelo menos , antes de adam smith .	the global economic financial crisis has reignited public interest in something that 's actually one of the oldest questions in economics , dating back to at least before adam smith .
ela podera ter ainda muito para aprender neste mundo , mas ja e especialista numa tarefa muito importante : dar sentido ao que ve .	she might still have a lot to learn about this world , but she 's already an expert at one very important task : to make sense of what she sees .
e tem sido etiquetadas , e tem sido encontradas com 70 anos de idade .	and they 've been tagged , and they 've been found to be 70 years old .
ira parecer-se um pouco com isto .	it 's going to look a little bit like that .
bom , nos podemos fazer isso por nos proprios .	well , we can do that for ourselves .
isto nao e incrivel ?	is n't that mind-blowing ?
dh : era a ted .	dh : it was ted .
e no entanto estas sao as mesmas qualidades pelas quais homens e mulheres tem sido honrados atraves de geracoes .	and yet these are the very qualities for which men and women have been honored throughout the generations .
bem , eu culpo a rainha .	well , i blame the queen .
franz kafka considerava incompleto o que outros consideravam obras dignas de elogio , de tal modo que queria que todos os seus diarios , manuscritos , cartas e ate mesmo rascunhos fossem queimados depois de ele morrer .	franz kafka saw incompletion when others would find only works to praise , so much so that he wanted all of his diaries , manuscripts , letters and even sketches burned upon his death .
assim , nao nos aposentamos .	so we did n't retire .
e agora ?	now what ?
bem , a 10 segundos por 3.000 carros , da 8.3 horas por dia . o salario medio nos e.u.a .	well , at 10 seconds per 3,000 cars , that 's 8.3 hours per day . the average wage in the u.s .
obrigado .	thank you .
`` o mais provavel e que fizeram o mesmo que o sr. domingos : `` '' ah ! o que e isto ? nao estou a perceber , vai para o lixo '' '' . ''	`` they most likely did the same as mr. domingos : `` '' ah ! what 's this ? i 'm not understanding , it 's going to the garbage '' '' . ''
a questao e que e ligeiramente perigosa .	the thing is , is that it 's slightly dangerous .
nao sei para que , mas tem um .	don’t know what they do with that , but they have one .
conversem com um astrofisico :	talk to any astrophysicist .
muitos destes sistemas tem o efeito contrario .	a lot of these systems have the converse effect .
como muitos dos que vivem entre o oriente e o ocidente , eu fui levada , ao longo dos anos , a tentar entender melhor as minhas origens .	like so many who straddle east and west , i 've been drawn , over the years , to try to better understand my origins .
( aplausos ) chris anderson : muito obrigado .	( applause ) chris anderson : thank you so much .
mas o que e muito impressionante e que , do nosso ponto de vista , podemos ver sempre a terra .	but what 's very impressive is that , from our vantage point , we can always see the earth .
`` `` entao bob , diga-me honestamente : o que acha do meu produto ? '' ''	so bob , just tell me honestly , what do you think of my product ?
e em ultimo lugar , eu acho que o publico pode tornar o mundo num sitio melhor desligando os seus telefones , afastando-se dos seus ecras , e entrando no mundo real , alem da sua zona de conforto .	and then lastly , i think that audiences can make the world a better place by switching off their phones , by stepping away from their screens and stepping out into the real world beyond what feels safe .
( audio ) mary tinha um cordeirinho ! cordeirinho ! cordeirinho !	( audio ) mary had a little lamb ! little lamb ! little lamb !
na verdade , eles resolveram o caso mais eficazmente .	actually , they solved the problem quite a lot more effectively .
chama-se uma prisao .	it 's called a prison .
existe um novo microbio , eu descobri-o .	there 's a new microbe , i just discovered it .
bem , todos nos aqui , aposto , tivemos alguns professores excelentes .	well , all of us here , i 'll bet , had some great teachers .
sentiam-se tao enjoados que voltavam para os hoteis a pe .	they were too nauseous , so they 'd walk back to their hotels .
podem ver que mais de 200 pessoas deram-lhe uma classificacao ed 4.99 em 5 .	you can see that over 200 people have given him an average rating over 4.99 out of 5 .
mas nao e legal transportar os livros de espanha para a america latina .	but it 's not legal to transport the books from spain to latin america .
atualmente , guardam algumas sementes do ano anterior e semeiam-nas manualmente com uma enxada .	currently , they take a little bit of saved food grain from the prior year , they plant it in the ground and they till it with a manual hand hoe .
quando eu era da vossa idade , nao sabiamos o que o universo iria fazer .	back when i was your age , we did n't know what the universe was going to do .
nao faz mal se recordarmos melhor tom hanks do que o astronauta jim lovell ou tivermos o rosto de ben kingsley sobreposto ao de gandhi .	and it 's okay if we remember tom hanks better than astronaut jim lovell or have ben kingsley 's face superimposed onto that of gandhi 's .
al gore : finalmente a alternativa positiva se mistura com o nosso desafio economico e o desafio da nossa seguranca nacional .	al gore : finally , the positive alternative meshes with our economic challenge and our national security challenge .
as alteracoes climaticas estao a afetar as nossas casas , as nossas comunidades , o nosso estilo de vida . deveriamos estar a preparar-nos a todos os niveis e a cada oportunidade .	climate change is affecting our homes , our communities , our way of life . we should be preparing at every scale and at every opportunity .
`` isso leva-me ao meu segundo `` '' slogan '' '' : `` e entao ? e agora ? '' ''	that brings me to my second slogan : so what ? now what ?
e depois tornou-se internacional . ( risos )	and then it went international . ( laughter )
e recentemente , nos anos 90 , no peru , as mulheres da regiao dos andes levavam anestesia e eram esterilizadas sem o saberem .	and as recently as the 1990s , in peru , women from the andes region were given anesthesia and they were sterilized without their knowledge .
o nivel mais fraco de resposta civil face a violencia e a negacao e a apatia .	the first level , the weakest level of civil response against violence , is denial and apathy .
mas a materialidade tambem importa , porque em qualquer sociedade que os antropologos investigaram , os bens materiais sao uma especie de linguagem — uma linguagem de bens , uma linguagem simbolica que utilizamos para contar historias uns aos outros — historias estas , por exemplo , de quao importante somos .	but the materiality matters too , because in every society that anthropologists have looked at , material stuff operates as a kind of language — a language of goods , a symbolic language that we use to tell each other stories — stories , for example , about how important we are .
ora , cada variavel fisiologica em que possam pensar , cada evento historico em que possam pensar , se o representarem desta maneira , tera este aspecto .	now any physiological variable you can think of , any life history event you can think of , if you plot it this way , looks like this .
que absurdo , nao e ?	so this is absurd , right ?
voz 4 : todo o extravazamento de afeicao e emocao que veio do nosso pais foi algo que ficara comigo para todo o sempre .	voice 4 : all the outpouring of affection and emotion that came from our country was something really that will forever , ever stay with me .
deixem-me agora voltar atras e dizer como foi bem mais diferente construir a buzzcar do que a zipcar . porque agora , cada coisa que fizemos tem um pouco dos dois corpos diferentes sobre os quais eu preciso de pensar : —os donos dos carros — e os condutores que os irao alugar .	so let me take you back how it 's so incredibly different building buzzcar than it was building zipcar , because now every single thing we do has these two different bodies that i have to be thinking about : the owners who are going to provide the cars and the drivers who are going to rent them .
regra simples numero um : entenda o que os outros fazem .	simple rule number one : understand what others do .
ha nova programabilidade nestes componentes .	there 's new programmability in these parts .
ca : 30 % por ano . ms : mas os apicultores dividem as colonias e assim conseguem manter o mesmo numero , conseguem recuperar parte das perdas .	ca : thirty percent a year . ms : but then beekeepers are able to divide their colonies and so they can maintain the same number , they can recuperate some of their loss .
mas , que outras coisas caracterizam a vida ?	but what else is life characterized by ?
a que e que teriam dito sim ?	what would you have said yes to ?
eu sou o elefante na sala .	i am the elephant in the room .
mas deixe-me mostrar-lhes um problema muito diferente .	but let me bring you to a very different problem .
esta e uma rede desenhada para reconhecer rostos , para distinguir um rosto de outro .	this is a network designed to recognize faces , to distinguish one face from another .
e se virem as tendencias aqui , por volta de 2008 , e nao penso que seja uma previsao louca representarao 2 % das vendas de carros .	and if you look at the trends here , by about 2008 — and i do n't think this is a crazy forecast — they 'll be two percent of auto sales .
ha algum tempo que e sabido que , se se prestar atencao ao carrier phase do sinal gps e se se tiver uma ligacao a internet , pode-se ir de uma precisao de metros para centimetros , ou ate milimetros de precisao .	for some time now , it 's been known that if you pay attention to the carrier phase of the gps signal , and if you have an internet connection , then you can go from meter level to centimeter level , even millimeter-level positioning .
nao requer a mecanica quantica para a explicar .	it does n't really require much in the way of quantum mechanics to explain it .
depois comecou a aplaudir .	and then he started clapping .
`` e eu : `` '' vieram ao sitio certo '' '' . ( risos ) criei isto com a minha mulher . ''	`` and i 'm like , `` '' you 've come to the right place . '' '' ( laughter ) i actually brought this up with my wife . ''
( video ) ( sons mecanicos ) ♫ e isso e tudo ♫ ♫ o que o amor e ♫ ♫ e vamo-nos lembrar ♫ ♫ quando acabar o tempo ♫ ♫ de que ele apenas ... ♫ ( risos ) as : contar uma historia sem dialogo .	( video ) ( mechanical sounds ) ♫ and that is all ♫ ♫ that love 's about ♫ ♫ and we 'll recall ♫ ♫ when time runs out ♫ ♫ that it only ♫ ( laughter ) as : storytelling without dialogue .
`` e muito bom — `` '' niveis e tendencias em mortalidade infantil '' '' — excepto esta pagina . ''	`` it 's very good — `` '' levels and trends in child mortality '' '' — except this page . ''
uma floresta pode ser uma parte integral da nossa existencia urbana .	a forest can be an integral part of our urban existence .
o que nao faz tanto sentido e que o universo , nos primordios , perto do big bang , era tambem muito , muito regular .	the thing that does n't make sense to us as much is that the universe , at early times , near the big bang , was also very , very smooth .
chama-se a maquina burocratica administrativa .	it 's called the bureaucratic administrative machine .
sem agua , as bacterias nao sobrevivem .	without water , the bacteria wo n't survive .
obrigado .	thank you .
`` na verdade , quando vi o `` '' supersize me - 30 dias de fast food '' '' , dei comigo a pensar : `` '' o que aconteceria `` se um individuo fizesse 31 dias de fox news , sem parar ? '' ''	`` in fact , when i saw `` '' supersize me , '' '' i starting thinking of saying , what would happen if an individual had 31 days nonstop fox news ? ''
( aplausos )	( applause )
o barco foi encontrado dois meses depois a deriva perto de franca .	they found her abandoned boat two months later adrift near france .
mas e um pouco similar ao que se ve com as vacinas .	but it is actually kind of similar to what you see in immune vaccines .
um rosto sem nome pode ajuda-los a sentirem-se um pouco menos ligados .	a face without a name might help them feel just a little less attached .
tambem temos de ter material organico , coisas que nos compoem , mas tambem coisas que precisamos de consumir .	we also have to have organic material — things that make us up , but also things that we need to consume .
e e um tipo de estrutura bastante incomum .	and it 's really an odd sort of structure .
alguma narrativa . arte interactiva . voces podem falar comigo .	somebody 's storytelling . interactive art . you can talk to me .
acho que temos de fazer algo relativamente a uma parte da cultura medica , que tem de mudar .	i think we have to do something about a piece of the culture of medicine that has to change .
podem sempre estar fenomenais por menos de 50 dolares .	you can almost always look phenomenal for under $ 50 .
o nosso objetivo e democratizar o processo da descoberta arqueologica e permitir que todos participem .	our goal is to democratize the process of archaeological discovery , and allow anyone to participate .
`` em hindu , sundar que dizer `` '' atraente '' '' . acredito que ha cinco licoes-chave que demonstrei neste slide que sao essencialmente importantes para a transferencia eficaz de tarefas . ''	`` what sundar stands for , in hindi , is `` '' attractive . '' '' it seems to me that there are five key lessons that i 've shown on this slide that are critically important for effective task shifting . ''
para sairem de um lugar de certeza , darem uma hipotese a alguem ou a algo desconhecido , vao precisar de forca para saltar sobre esse fosso , e essa forca excecional e a confianca .	for you to leap from a place of certainty , to take a chance on that someone or something unknown , you need a force to pull you over the gap , and that remarkable force is trust .
a sua religiao , a sua isolacao , o seu profundo respeito pela sua cultura e agora os principios de seu movimento fib todos geram um sentimento de gratidao sobre o que eles tem .	their religion , their isolation , their deep respect for their culture and now the principles of their gnh movement all have fostered a sense of gratitude about what they do have .
a goldman sachs previu que a china , a economia chinesa , ultrapassara a dos eua	goldman sachs has projected that china , the chinese economy , will surpass that of the u.s .
e isso permite-nos compreender quem esta a faze-lo bem , e chama-los , e perceber que tecnicas sao essas .	and that allows us to understand who 's doing it well , and call them out , and find out what those techniques are .
entao , fui contar as enfermeiras .	well , so i did tell the nurses .
imaginem , por favor , estas duas ideias juntas .	imagine , if you will , these two ideas together .
