aaa	aaa
aab	aab
aac	aac
aad	aad
aae	aae
aaf	aaf
aag	aag
aah	aah
aai	aai
aaj	aaj
aak	aak
aal	aal
aam	aam
aan	aan
aao	aao
aap	aap
aaq	aaq
aar	aar
aas	aas
aat	aat
aau	aau
aav	aav
aaw	aaw
aax	aax
aay	aay
aaz	aaz
aba	aba
abb	abb
abc	abc
abd	abd
abe	abe
abf	abf
abg	abg
abh	abh
abi	abi
abj	abj
abk	abk
abl	abl
abm	abm
abn	abn
abo	abo
abp	abp
abq	abq
abr	abr
abs	abs
abt	abt
abu	abu
abv	abv
abw	abw
abx	abx
aby	aby
abz	abz
aca	aca
acb	acb
acc	acc
acd	acd
ace	ace
acf	acf
acg	acg
ach	ach
aci	aci
acj	acj
ack	ack
acl	acl
acm	acm
acn	acn
aco	aco
acp	acp
acq	acq
acr	acr
acs	acs
act	act
acu	acu
acv	acv
acw	acw
acx	acx
acy	acy
acz	acz
ada	ada
adb	adb
adc	adc
add	add
ade	ade
adf	adf
adg	adg
adh	adh
adi	adi
adj	adj
adk	adk
adl	adl
adm	adm
adn	adn
ado	ado
adp	adp
adq	adq
adr	adr
ads	ads
adt	adt
adu	adu
adv	adv
adw	adw
adx	adx
ady	ady
adz	adz
aea	aea
aeb	aeb
aec	aec
aed	aed
aee	aee
aef	aef
aeg	aeg
aeh	aeh
aei	aei
aej	aej
aek	aek
ael	ael
aem	aem
aen	aen
aeo	aeo
aep	aep
aeq	aeq
aer	aer
aes	aes
aet	aet
aeu	aeu
aev	aev
aew	aew
aex	aex
aey	aey
aez	aez
afa	afa
afb	afb
afc	afc
afd	afd
afe	afe
aff	aff
afg	afg
afh	afh
afi	afi
afj	afj
afk	afk
afl	afl
afm	afm
afn	afn
afo	afo
afp	afp
afq	afq
afr	afr
afs	afs
aft	aft
afu	afu
afv	afv
afw	afw
afx	afx
afy	afy
afz	afz
aga	aga
agb	agb
agc	agc
agd	agd
age	age
agf	agf
agg	agg
agh	agh
agi	agi
agj	agj
agk	agk
agl	agl
agm	agm
agn	agn
ago	ago
agp	agp
agq	agq
agr	agr
ags	ags
agt	agt
agu	agu
agv	agv
agw	agw
agx	agx
agy	agy
agz	agz
aha	aha
ahb	ahb
ahc	ahc
ahd	ahd
ahe	ahe
ahf	ahf
ahg	ahg
ahh	ahh
ahi	ahi
ahj	ahj
ahk	ahk
ahl	ahl
ahm	ahm
ahn	ahn
aho	aho
ahp	ahp
ahq	ahq
ahr	ahr
ahs	ahs
aht	aht
ahu	ahu
ahv	ahv
ahw	ahw
ahx	ahx
ahy	ahy
ahz	ahz
aia	aia
aib	aib
aic	aic
aid	aid
aie	aie
aif	aif
aig	aig
aih	aih
aii	aii
aij	aij
aik	aik
ail	ail
aim	aim
ain	ain
aio	aio
aip	aip
aiq	aiq
air	air
ais	ais
ait	ait
aiu	aiu
aiv	aiv
aiw	aiw
aix	aix
aiy	aiy
aiz	aiz
aja	aja
ajb	ajb
ajc	ajc
ajd	ajd
aje	aje
ajf	ajf
ajg	ajg
ajh	ajh
aji	aji
ajj	ajj
ajk	ajk
ajl	ajl
ajm	ajm
ajn	ajn
ajo	ajo
ajp	ajp
ajq	ajq
ajr	ajr
ajs	ajs
ajt	ajt
aju	aju
ajv	ajv
ajw	ajw
ajx	ajx
ajy	ajy
ajz	ajz
aka	aka
akb	akb
akc	akc
akd	akd
ake	ake
akf	akf
akg	akg
akh	akh
aki	aki
akj	akj
akk	akk
akl	akl
akm	akm
akn	akn
ako	ako
akp	akp
akq	akq
akr	akr
aks	aks
akt	akt
aku	aku
akv	akv
akw	akw
akx	akx
aky	aky
akz	akz
ala	ala
alb	alb
alc	alc
ald	ald
ale	ale
alf	alf
alg	alg
alh	alh
ali	ali
alj	alj
alk	alk
all	all
alm	alm
aln	aln
alo	alo
alp	alp
alq	alq
alr	alr
als	als
alt	alt
alu	alu
alv	alv
alw	alw
alx	alx
aly	aly
alz	alz
ama	ama
amb	amb
amc	amc
amd	amd
ame	ame
amf	amf
amg	amg
amh	amh
ami	ami
amj	amj
amk	amk
aml	aml
amm	amm
amn	amn
amo	amo
amp	amp
amq	amq
amr	amr
ams	ams
amt	amt
amu	amu
amv	amv
amw	amw
amx	amx
amy	amy
amz	amz
ana	ana
anb	anb
anc	anc
and	and
ane	ane
anf	anf
ang	ang
anh	anh
ani	ani
anj	anj
ank	ank
anl	anl
anm	anm
ann	ann
ano	ano
anp	anp
anq	anq
anr	anr
ans	ans
ant	ant
anu	anu
anv	anv
anw	anw
anx	anx
any	any
anz	anz
aoa	aoa
aob	aob
aoc	aoc
aod	aod
aoe	aoe
aof	aof
aog	aog
aoh	aoh
aoi	aoi
aoj	aoj
aok	aok
aol	aol
aom	aom
aon	aon
aoo	aoo
aop	aop
aoq	aoq
aor	aor
aos	aos
aot	aot
aou	aou
aov	aov
aow	aow
aox	aox
aoy	aoy
aoz	aoz
apa	apa
apb	apb
apc	apc
apd	apd
ape	ape
apf	apf
apg	apg
aph	aph
api	api
apj	apj
apk	apk
apl	apl
apm	apm
apn	apn
apo	apo
app	app
apq	apq
apr	apr
aps	aps
apt	apt
apu	apu
apv	apv
apw	apw
apx	apx
apy	apy
apz	apz
aqa	aqa
aqb	aqb
aqc	aqc
aqd	aqd
aqe	aqe
aqf	aqf
aqg	aqg
aqh	aqh
aqi	aqi
aqj	aqj
aqk	aqk
aql	aql
aqm	aqm
aqn	aqn
aqo	aqo
aqp	aqp
aqq	aqq
aqr	aqr
aqs	aqs
aqt	aqt
aqu	aqu
aqv	aqv
aqw	aqw
aqx	aqx
aqy	aqy
aqz	aqz
ara	ara
arb	arb
arc	arc
ard	ard
are	are
arf	arf
arg	arg
arh	arh
ari	ari
arj	arj
ark	ark
arl	arl
arm	arm
arn	arn
aro	aro
arp	arp
arq	arq
arr	arr
ars	ars
art	art
aru	aru
arv	arv
arw	arw
arx	arx
ary	ary
arz	arz
asa	asa
asb	asb
asc	asc
asd	asd
ase	ase
asf	asf
asg	asg
ash	ash
asi	asi
asj	asj
ask	ask
asl	asl
asm	asm
asn	asn
aso	aso
asp	asp
asq	asq
asr	asr
ass	ass
ast	ast
asu	asu
asv	asv
asw	asw
asx	asx
asy	asy
asz	asz
ata	ata
atb	atb
atc	atc
atd	atd
ate	ate
atf	atf
atg	atg
ath	ath
ati	ati
atj	atj
atk	atk
atl	atl
atm	atm
atn	atn
ato	ato
atp	atp
atq	atq
atr	atr
ats	ats
att	att
atu	atu
atv	atv
atw	atw
atx	atx
aty	aty
atz	atz
aua	aua
aub	aub
auc	auc
aud	aud
aue	aue
auf	auf
aug	aug
auh	auh
aui	aui
auj	auj
auk	auk
aul	aul
aum	aum
aun	aun
auo	auo
aup	aup
auq	auq
aur	aur
aus	aus
aut	aut
auu	auu
auv	auv
auw	auw
aux	aux
auy	auy
auz	auz
ava	ava
avb	avb
avc	avc
avd	avd
ave	ave
avf	avf
avg	avg
avh	avh
avi	avi
avj	avj
avk	avk
avl	avl
avm	avm
avn	avn
avo	avo
avp	avp
avq	avq
avr	avr
avs	avs
avt	avt
avu	avu
avv	avv
avw	avw
avx	avx
avy	avy
avz	avz
awa	awa
awb	awb
awc	awc
awd	awd
awe	awe
awf	awf
awg	awg
awh	awh
awi	awi
awj	awj
awk	awk
awl	awl
awm	awm
awn	awn
awo	awo
awp	awp
awq	awq
awr	awr
aws	aws
awt	awt
awu	awu
awv	awv
aww	aww
awx	awx
awy	awy
awz	awz
axa	axa
axb	axb
axc	axc
axd	axd
axe	axe
axf	axf
axg	axg
axh	axh
axi	axi
axj	axj
axk	axk
axl	axl
axm	axm
axn	axn
axo	axo
axp	axp
axq	axq
axr	axr
axs	axs
axt	axt
axu	axu
axv	axv
axw	axw
axx	axx
axy	axy
axz	axz
aya	aya
ayb	ayb
ayc	ayc
ayd	ayd
aye	aye
ayf	ayf
ayg	ayg
ayh	ayh
ayi	ayi
ayj	ayj
ayk	ayk
ayl	ayl
aym	aym
ayn	ayn
ayo	ayo
ayp	ayp
ayq	ayq
ayr	ayr
ays	ays
ayt	ayt
ayu	ayu
ayv	ayv
ayw	ayw
ayx	ayx
ayy	ayy
ayz	ayz
aza	aza
azb	azb
azc	azc
azd	azd
aze	aze
azf	azf
azg	azg
azh	azh
azi	azi
azj	azj
azk	azk
azl	azl
azm	azm
azn	azn
azo	azo
azp	azp
azq	azq
azr	azr
azs	azs
azt	azt
azu	azu
azv	azv
azw	azw
azx	azx
azy	azy
azz	azz
baa	baa
bab	bab
bac	bac
bad	bad
bae	bae
baf	baf
bag	bag
bah	bah
bai	bai
baj	baj
bak	bak
bal	bal
bam	bam
ban	ban
bao	bao
bap	bap
baq	baq
bar	bar
bas	bas
bat	bat
bau	bau
bav	bav
baw	baw
bax	bax
bay	bay
baz	baz
bba	bba
bbb	bbb
bbc	bbc
bbd	bbd
bbe	bbe
bbf	bbf
bbg	bbg
bbh	bbh
bbi	bbi
bbj	bbj
bbk	bbk
bbl	bbl
bbm	bbm
bbn	bbn
bbo	bbo
bbp	bbp
bbq	bbq
bbr	bbr
bbs	bbs
bbt	bbt
bbu	bbu
bbv	bbv
bbw	bbw
bbx	bbx
bby	bby
bbz	bbz
bca	bca
bcb	bcb
bcc	bcc
bcd	bcd
bce	bce
bcf	bcf
bcg	bcg
bch	bch
bci	bci
bcj	bcj
bck	bck
bcl	bcl
bcm	bcm
bcn	bcn
bco	bco
bcp	bcp
bcq	bcq
bcr	bcr
bcs	bcs
bct	bct
bcu	bcu
bcv	bcv
bcw	bcw
bcx	bcx
bcy	bcy
bcz	bcz
bda	bda
bdb	bdb
bdc	bdc
bdd	bdd
bde	bde
bdf	bdf
bdg	bdg
bdh	bdh
bdi	bdi
bdj	bdj
bdk	bdk
bdl	bdl
bdm	bdm
bdn	bdn
bdo	bdo
bdp	bdp
bdq	bdq
bdr	bdr
bds	bds
bdt	bdt
bdu	bdu
bdv	bdv
bdw	bdw
bdx	bdx
bdy	bdy
bdz	bdz
bea	bea
beb	beb
bec	bec
bed	bed
bee	bee
bef	bef
beg	beg
beh	beh
bei	bei
bej	bej
bek	bek
bel	bel
bem	bem
ben	ben
beo	beo
bep	bep
beq	beq
ber	ber
bes	bes
bet	bet
beu	beu
bev	bev
bew	bew
bex	bex
bey	bey
bez	bez
bfa	bfa
bfb	bfb
bfc	bfc
bfd	bfd
bfe	bfe
bff	bff
bfg	bfg
bfh	bfh
bfi	bfi
bfj	bfj
bfk	bfk
bfl	bfl
bfm	bfm
bfn	bfn
bfo	bfo
bfp	bfp
bfq	bfq
bfr	bfr
bfs	bfs
bft	bft
bfu	bfu
bfv	bfv
bfw	bfw
bfx	bfx
bfy	bfy
bfz	bfz
bga	bga
bgb	bgb
bgc	bgc
bgd	bgd
bge	bge
bgf	bgf
bgg	bgg
bgh	bgh
bgi	bgi
bgj	bgj
bgk	bgk
bgl	bgl
bgm	bgm
bgn	bgn
bgo	bgo
bgp	bgp
bgq	bgq
bgr	bgr
bgs	bgs
bgt	bgt
bgu	bgu
bgv	bgv
bgw	bgw
bgx	bgx
bgy	bgy
bgz	bgz
bha	bha
bhb	bhb
bhc	bhc
bhd	bhd
bhe	bhe
bhf	bhf
bhg	bhg
bhh	bhh
bhi	bhi
bhj	bhj
bhk	bhk
bhl	bhl
bhm	bhm
bhn	bhn
bho	bho
bhp	bhp
bhq	bhq
bhr	bhr
bhs	bhs
bht	bht
bhu	bhu
bhv	bhv
bhw	bhw
bhx	bhx
bhy	bhy
bhz	bhz
bia	bia
bib	bib
bic	bic
bid	bid
bie	bie
bif	bif
big	big
bih	bih
bii	bii
bij	bij
bik	bik
bil	bil
bim	bim
bin	bin
bio	bio
bip	bip
biq	biq
bir	bir
bis	bis
bit	bit
biu	biu
biv	biv
biw	biw
bix	bix
biy	biy
biz	biz
bja	bja
bjb	bjb
bjc	bjc
bjd	bjd
bje	bje
bjf	bjf
bjg	bjg
bjh	bjh
bji	bji
bjj	bjj
bjk	bjk
bjl	bjl
bjm	bjm
bjn	bjn
bjo	bjo
bjp	bjp
bjq	bjq
bjr	bjr
bjs	bjs
bjt	bjt
bju	bju
bjv	bjv
bjw	bjw
bjx	bjx
bjy	bjy
bjz	bjz
bka	bka
bkb	bkb
bkc	bkc
bkd	bkd
bke	bke
bkf	bkf
bkg	bkg
bkh	bkh
bki	bki
bkj	bkj
bkk	bkk
bkl	bkl
bkm	bkm
bkn	bkn
bko	bko
bkp	bkp
bkq	bkq
bkr	bkr
bks	bks
bkt	bkt
bku	bku
bkv	bkv
bkw	bkw
bkx	bkx
bky	bky
bkz	bkz
bla	bla
blb	blb
blc	blc
bld	bld
ble	ble
blf	blf
blg	blg
blh	blh
bli	bli
blj	blj
blk	blk
bll	bll
blm	blm
bln	bln
blo	blo
blp	blp
blq	blq
blr	blr
bls	bls
blt	blt
blu	blu
blv	blv
blw	blw
blx	blx
bly	bly
blz	blz
bma	bma
bmb	bmb
bmc	bmc
bmd	bmd
bme	bme
bmf	bmf
bmg	bmg
bmh	bmh
bmi	bmi
bmj	bmj
bmk	bmk
bml	bml
bmm	bmm
bmn	bmn
bmo	bmo
bmp	bmp
bmq	bmq
bmr	bmr
bms	bms
bmt	bmt
bmu	bmu
bmv	bmv
bmw	bmw
bmx	bmx
bmy	bmy
bmz	bmz
bna	bna
bnb	bnb
bnc	bnc
bnd	bnd
bne	bne
bnf	bnf
bng	bng
bnh	bnh
bni	bni
bnj	bnj
bnk	bnk
bnl	bnl
bnm	bnm
bnn	bnn
bno	bno
bnp	bnp
bnq	bnq
bnr	bnr
bns	bns
bnt	bnt
bnu	bnu
bnv	bnv
bnw	bnw
bnx	bnx
bny	bny
bnz	bnz
boa	boa
bob	bob
boc	boc
bod	bod
boe	boe
bof	bof
bog	bog
boh	boh
boi	boi
boj	boj
bok	bok
bol	bol
bom	bom
bon	bon
boo	boo
bop	bop
boq	boq
bor	bor
bos	bos
bot	bot
bou	bou
bov	bov
bow	bow
box	box
boy	boy
boz	boz
bpa	bpa
bpb	bpb
bpc	bpc
bpd	bpd
bpe	bpe
bpf	bpf
bpg	bpg
bph	bph
bpi	bpi
bpj	bpj
bpk	bpk
bpl	bpl
bpm	bpm
bpn	bpn
bpo	bpo
bpp	bpp
bpq	bpq
bpr	bpr
bps	bps
bpt	bpt
bpu	bpu
bpv	bpv
bpw	bpw
bpx	bpx
bpy	bpy
bpz	bpz
bqa	bqa
bqb	bqb
bqc	bqc
bqd	bqd
bqe	bqe
bqf	bqf
bqg	bqg
bqh	bqh
bqi	bqi
bqj	bqj
bqk	bqk
bql	bql
bqm	bqm
bqn	bqn
bqo	bqo
bqp	bqp
bqq	bqq
bqr	bqr
bqs	bqs
bqt	bqt
bqu	bqu
bqv	bqv
bqw	bqw
bqx	bqx
bqy	bqy
bqz	bqz
bra	bra
brb	brb
brc	brc
brd	brd
bre	bre
brf	brf
brg	brg
brh	brh
bri	bri
brj	brj
brk	brk
brl	brl
brm	brm
brn	brn
bro	bro
brp	brp
brq	brq
brr	brr
brs	brs
brt	brt
bru	bru
brv	brv
brw	brw
brx	brx
bry	bry
brz	brz
bsa	bsa
bsb	bsb
bsc	bsc
bsd	bsd
bse	bse
bsf	bsf
bsg	bsg
bsh	bsh
bsi	bsi
bsj	bsj
bsk	bsk
bsl	bsl
bsm	bsm
bsn	bsn
bso	bso
bsp	bsp
bsq	bsq
bsr	bsr
bss	bss
bst	bst
bsu	bsu
bsv	bsv
bsw	bsw
bsx	bsx
bsy	bsy
bsz	bsz
bta	bta
btb	btb
btc	btc
btd	btd
bte	bte
btf	btf
btg	btg
bth	bth
bti	bti
btj	btj
btk	btk
btl	btl
btm	btm
btn	btn
bto	bto
btp	btp
btq	btq
btr	btr
bts	bts
btt	btt
btu	btu
btv	btv
btw	btw
btx	btx
bty	bty
btz	btz
bua	bua
bub	bub
buc	buc
bud	bud
bue	bue
buf	buf
bug	bug
buh	buh
bui	bui
buj	buj
buk	buk
bul	bul
bum	bum
bun	bun
buo	buo
bup	bup
buq	buq
bur	bur
bus	bus
but	but
buu	buu
buv	buv
buw	buw
bux	bux
buy	buy
buz	buz
bva	bva
bvb	bvb
bvc	bvc
bvd	bvd
bve	bve
bvf	bvf
bvg	bvg
bvh	bvh
bvi	bvi
bvj	bvj
bvk	bvk
bvl	bvl
bvm	bvm
bvn	bvn
bvo	bvo
bvp	bvp
bvq	bvq
bvr	bvr
bvs	bvs
bvt	bvt
bvu	bvu
bvv	bvv
bvw	bvw
bvx	bvx
bvy	bvy
bvz	bvz
bwa	bwa
bwb	bwb
bwc	bwc
bwd	bwd
bwe	bwe
bwf	bwf
bwg	bwg
bwh	bwh
bwi	bwi
bwj	bwj
bwk	bwk
bwl	bwl
bwm	bwm
bwn	bwn
bwo	bwo
bwp	bwp
bwq	bwq
bwr	bwr
bws	bws
bwt	bwt
bwu	bwu
bwv	bwv
bww	bww
bwx	bwx
bwy	bwy
bwz	bwz
bxa	bxa
bxb	bxb
bxc	bxc
bxd	bxd
bxe	bxe
bxf	bxf
bxg	bxg
bxh	bxh
bxi	bxi
bxj	bxj
bxk	bxk
bxl	bxl
bxm	bxm
bxn	bxn
bxo	bxo
bxp	bxp
bxq	bxq
bxr	bxr
bxs	bxs
bxt	bxt
bxu	bxu
bxv	bxv
bxw	bxw
bxx	bxx
bxy	bxy
bxz	bxz
bya	bya
byb	byb
byc	byc
byd	byd
bye	bye
byf	byf
byg	byg
byh	byh
byi	byi
byj	byj
byk	byk
byl	byl
bym	bym
byn	byn
byo	byo
byp	byp
byq	byq
byr	byr
bys	bys
byt	byt
byu	byu
byv	byv
byw	byw
byx	byx
byy	byy
byz	byz
bza	bza
bzb	bzb
bzc	bzc
bzd	bzd
bze	bze
bzf	bzf
bzg	bzg
bzh	bzh
bzi	bzi
bzj	bzj
bzk	bzk
bzl	bzl
bzm	bzm
bzn	bzn
bzo	bzo
bzp	bzp
bzq	bzq
bzr	bzr
bzs	bzs
bzt	bzt
bzu	bzu
bzv	bzv
bzw	bzw
bzx	bzx
bzy	bzy
bzz	bzz
caa	caa
cab	cab
cac	cac
cad	cad
cae	cae
caf	caf
cag	cag
cah	cah
cai	cai
caj	caj
cak	cak
cal	cal
cam	cam
can	can
cao	cao
cap	cap
caq	caq
car	car
cas	cas
cat	cat
cau	cau
cav	cav
caw	caw
cax	cax
cay	cay
caz	caz
cba	cba
cbb	cbb
cbc	cbc
cbd	cbd
cbe	cbe
cbf	cbf
cbg	cbg
cbh	cbh
cbi	cbi
cbj	cbj
cbk	cbk
cbl	cbl
cbm	cbm
cbn	cbn
cbo	cbo
cbp	cbp
cbq	cbq
cbr	cbr
cbs	cbs
cbt	cbt
cbu	cbu
cbv	cbv
cbw	cbw
cbx	cbx
cby	cby
cbz	cbz
cca	cca
ccb	ccb
ccc	ccc
ccd	ccd
cce	cce
ccf	ccf
ccg	ccg
cch	cch
cci	cci
ccj	ccj
cck	cck
ccl	ccl
ccm	ccm
ccn	ccn
cco	cco
ccp	ccp
ccq	ccq
ccr	ccr
ccs	ccs
cct	cct
ccu	ccu
ccv	ccv
ccw	ccw
ccx	ccx
ccy	ccy
ccz	ccz
cda	cda
cdb	cdb
cdc	cdc
cdd	cdd
cde	cde
cdf	cdf
cdg	cdg
cdh	cdh
cdi	cdi
cdj	cdj
cdk	cdk
cdl	cdl
cdm	cdm
cdn	cdn
cdo	cdo
cdp	cdp
cdq	cdq
cdr	cdr
cds	cds
cdt	cdt
cdu	cdu
cdv	cdv
cdw	cdw
cdx	cdx
cdy	cdy
cdz	cdz
cea	cea
ceb	ceb
cec	cec
ced	ced
cee	cee
cef	cef
ceg	ceg
ceh	ceh
cei	cei
cej	cej
cek	cek
cel	cel
cem	cem
cen	cen
ceo	ceo
cep	cep
ceq	ceq
cer	cer
ces	ces
cet	cet
ceu	ceu
cev	cev
cew	cew
cex	cex
cey	cey
cez	cez
cfa	cfa
cfb	cfb
cfc	cfc
cfd	cfd
cfe	cfe
cff	cff
cfg	cfg
cfh	cfh
cfi	cfi
cfj	cfj
cfk	cfk
cfl	cfl
cfm	cfm
cfn	cfn
cfo	cfo
cfp	cfp
cfq	cfq
cfr	cfr
cfs	cfs
cft	cft
cfu	cfu
cfv	cfv
cfw	cfw
cfx	cfx
cfy	cfy
cfz	cfz
cga	cga
cgb	cgb
cgc	cgc
cgd	cgd
cge	cge
cgf	cgf
cgg	cgg
cgh	cgh
cgi	cgi
cgj	cgj
cgk	cgk
cgl	cgl
cgm	cgm
cgn	cgn
cgo	cgo
cgp	cgp
cgq	cgq
cgr	cgr
cgs	cgs
cgt	cgt
cgu	cgu
cgv	cgv
cgw	cgw
cgx	cgx
cgy	cgy
cgz	cgz
cha	cha
chb	chb
chc	chc
chd	chd
che	che
chf	chf
chg	chg
chh	chh
chi	chi
chj	chj
chk	chk
chl	chl
chm	chm
chn	chn
cho	cho
chp	chp
chq	chq
chr	chr
chs	chs
cht	cht
chu	chu
chv	chv
chw	chw
chx	chx
chy	chy
chz	chz
cia	cia
cib	cib
cic	cic
cid	cid
cie	cie
cif	cif
cig	cig
cih	cih
cii	cii
cij	cij
cik	cik
cil	cil
cim	cim
cin	cin
cio	cio
cip	cip
ciq	ciq
cir	cir
cis	cis
cit	cit
ciu	ciu
civ	civ
ciw	ciw
cix	cix
ciy	ciy
ciz	ciz
cja	cja
cjb	cjb
cjc	cjc
cjd	cjd
cje	cje
cjf	cjf
cjg	cjg
cjh	cjh
cji	cji
cjj	cjj
cjk	cjk
cjl	cjl
cjm	cjm
cjn	cjn
cjo	cjo
cjp	cjp
cjq	cjq
cjr	cjr
cjs	cjs
cjt	cjt
cju	cju
cjv	cjv
cjw	cjw
cjx	cjx
cjy	cjy
cjz	cjz
cka	cka
ckb	ckb
ckc	ckc
ckd	ckd
cke	cke
ckf	ckf
ckg	ckg
ckh	ckh
cki	cki
ckj	ckj
ckk	ckk
ckl	ckl
ckm	ckm
ckn	ckn
cko	cko
ckp	ckp
ckq	ckq
ckr	ckr
cks	cks
ckt	ckt
cku	cku
ckv	ckv
ckw	ckw
ckx	ckx
cky	cky
ckz	ckz
cla	cla
clb	clb
clc	clc
cld	cld
cle	cle
clf	clf
clg	clg
clh	clh
cli	cli
clj	clj
clk	clk
cll	cll
clm	clm
cln	cln
clo	clo
clp	clp
clq	clq
clr	clr
cls	cls
clt	clt
clu	clu
clv	clv
clw	clw
clx	clx
cly	cly
clz	clz
cma	cma
cmb	cmb
cmc	cmc
cmd	cmd
cme	cme
cmf	cmf
cmg	cmg
cmh	cmh
cmi	cmi
cmj	cmj
cmk	cmk
cml	cml
cmm	cmm
cmn	cmn
cmo	cmo
cmp	cmp
cmq	cmq
cmr	cmr
cms	cms
cmt	cmt
cmu	cmu
cmv	cmv
cmw	cmw
cmx	cmx
cmy	cmy
cmz	cmz
cna	cna
cnb	cnb
cnc	cnc
cnd	cnd
cne	cne
cnf	cnf
cng	cng
cnh	cnh
cni	cni
cnj	cnj
cnk	cnk
cnl	cnl
cnm	cnm
cnn	cnn
cno	cno
cnp	cnp
cnq	cnq
cnr	cnr
cns	cns
cnt	cnt
cnu	cnu
cnv	cnv
cnw	cnw
cnx	cnx
cny	cny
cnz	cnz
coa	coa
cob	cob
coc	coc
cod	cod
coe	coe
cof	cof
cog	cog
coh	coh
coi	coi
coj	coj
cok	cok
col	col
com	com
con	con
coo	coo
cop	cop
coq	coq
cor	cor
cos	cos
cot	cot
cou	cou
cov	cov
cow	cow
cox	cox
coy	coy
coz	coz
cpa	cpa
cpb	cpb
cpc	cpc
cpd	cpd
cpe	cpe
cpf	cpf
cpg	cpg
cph	cph
cpi	cpi
cpj	cpj
cpk	cpk
cpl	cpl
cpm	cpm
cpn	cpn
cpo	cpo
cpp	cpp
cpq	cpq
cpr	cpr
cps	cps
cpt	cpt
cpu	cpu
cpv	cpv
cpw	cpw
cpx	cpx
cpy	cpy
cpz	cpz
cqa	cqa
cqb	cqb
cqc	cqc
cqd	cqd
cqe	cqe
cqf	cqf
cqg	cqg
cqh	cqh
cqi	cqi
cqj	cqj
cqk	cqk
cql	cql
cqm	cqm
cqn	cqn
cqo	cqo
cqp	cqp
cqq	cqq
cqr	cqr
cqs	cqs
cqt	cqt
cqu	cqu
cqv	cqv
cqw	cqw
cqx	cqx
cqy	cqy
cqz	cqz
cra	cra
crb	crb
crc	crc
crd	crd
cre	cre
crf	crf
crg	crg
crh	crh
cri	cri
crj	crj
crk	crk
crl	crl
crm	crm
crn	crn
cro	cro
crp	crp
crq	crq
crr	crr
crs	crs
crt	crt
cru	cru
crv	crv
crw	crw
crx	crx
cry	cry
crz	crz
csa	csa
csb	csb
csc	csc
csd	csd
cse	cse
csf	csf
csg	csg
csh	csh
csi	csi
csj	csj
csk	csk
csl	csl
csm	csm
csn	csn
cso	cso
csp	csp
csq	csq
csr	csr
css	css
cst	cst
csu	csu
csv	csv
csw	csw
csx	csx
csy	csy
csz	csz
cta	cta
ctb	ctb
ctc	ctc
ctd	ctd
cte	cte
ctf	ctf
ctg	ctg
cth	cth
cti	cti
ctj	ctj
ctk	ctk
ctl	ctl
ctm	ctm
ctn	ctn
cto	cto
ctp	ctp
ctq	ctq
ctr	ctr
cts	cts
ctt	ctt
ctu	ctu
ctv	ctv
ctw	ctw
ctx	ctx
cty	cty
ctz	ctz
cua	cua
cub	cub
cuc	cuc
cud	cud
cue	cue
cuf	cuf
cug	cug
cuh	cuh
cui	cui
cuj	cuj
cuk	cuk
cul	cul
cum	cum
cun	cun
cuo	cuo
cup	cup
cuq	cuq
cur	cur
cus	cus
cut	cut
cuu	cuu
cuv	cuv
cuw	cuw
cux	cux
cuy	cuy
cuz	cuz
cva	cva
cvb	cvb
cvc	cvc
cvd	cvd
cve	cve
cvf	cvf
cvg	cvg
cvh	cvh
cvi	cvi
cvj	cvj
cvk	cvk
cvl	cvl
cvm	cvm
cvn	cvn
cvo	cvo
cvp	cvp
cvq	cvq
cvr	cvr
cvs	cvs
cvt	cvt
cvu	cvu
cvv	cvv
cvw	cvw
cvx	cvx
cvy	cvy
cvz	cvz
cwa	cwa
cwb	cwb
cwc	cwc
cwd	cwd
cwe	cwe
cwf	cwf
cwg	cwg
cwh	cwh
cwi	cwi
cwj	cwj
cwk	cwk
cwl	cwl
cwm	cwm
cwn	cwn
cwo	cwo
cwp	cwp
cwq	cwq
cwr	cwr
cws	cws
cwt	cwt
cwu	cwu
cwv	cwv
cww	cww
cwx	cwx
cwy	cwy
cwz	cwz
cxa	cxa
cxb	cxb
cxc	cxc
cxd	cxd
cxe	cxe
cxf	cxf
cxg	cxg
cxh	cxh
cxi	cxi
cxj	cxj
cxk	cxk
cxl	cxl
cxm	cxm
cxn	cxn
cxo	cxo
cxp	cxp
cxq	cxq
cxr	cxr
cxs	cxs
cxt	cxt
cxu	cxu
cxv	cxv
cxw	cxw
cxx	cxx
cxy	cxy
cxz	cxz
cya	cya
cyb	cyb
cyc	cyc
cyd	cyd
cye	cye
cyf	cyf
cyg	cyg
cyh	cyh
cyi	cyi
cyj	cyj
cyk	cyk
cyl	cyl
cym	cym
cyn	cyn
cyo	cyo
cyp	cyp
cyq	cyq
cyr	cyr
cys	cys
cyt	cyt
cyu	cyu
cyv	cyv
cyw	cyw
cyx	cyx
cyy	cyy
cyz	cyz
cza	cza
czb	czb
czc	czc
czd	czd
cze	cze
czf	czf
czg	czg
czh	czh
czi	czi
czj	czj
czk	czk
czl	czl
czm	czm
czn	czn
czo	czo
czp	czp
czq	czq
czr	czr
czs	czs
czt	czt
czu	czu
czv	czv
czw	czw
czx	czx
czy	czy
czz	czz
daa	daa
dab	dab
dac	dac
dad	dad
dae	dae
daf	daf
dag	dag
dah	dah
dai	dai
daj	daj
dak	dak
dal	dal
dam	dam
dan	dan
dao	dao
dap	dap
daq	daq
dar	dar
das	das
dat	dat
dau	dau
dav	dav
daw	daw
dax	dax
day	day
daz	daz
dba	dba
dbb	dbb
dbc	dbc
dbd	dbd
dbe	dbe
dbf	dbf
dbg	dbg
dbh	dbh
dbi	dbi
dbj	dbj
dbk	dbk
dbl	dbl
dbm	dbm
dbn	dbn
dbo	dbo
dbp	dbp
dbq	dbq
dbr	dbr
dbs	dbs
dbt	dbt
dbu	dbu
dbv	dbv
dbw	dbw
dbx	dbx
dby	dby
dbz	dbz
dca	dca
dcb	dcb
dcc	dcc
dcd	dcd
dce	dce
dcf	dcf
dcg	dcg
dch	dch
dci	dci
dcj	dcj
dck	dck
dcl	dcl
dcm	dcm
dcn	dcn
dco	dco
dcp	dcp
dcq	dcq
dcr	dcr
dcs	dcs
dct	dct
dcu	dcu
dcv	dcv
dcw	dcw
dcx	dcx
dcy	dcy
dcz	dcz
dda	dda
ddb	ddb
ddc	ddc
ddd	ddd
dde	dde
ddf	ddf
ddg	ddg
ddh	ddh
ddi	ddi
ddj	ddj
ddk	ddk
ddl	ddl
ddm	ddm
ddn	ddn
ddo	ddo
ddp	ddp
ddq	ddq
ddr	ddr
dds	dds
ddt	ddt
ddu	ddu
ddv	ddv
ddw	ddw
ddx	ddx
ddy	ddy
ddz	ddz
dea	dea
deb	deb
dec	dec
ded	ded
dee	dee
def	def
deg	deg
deh	deh
dei	dei
dej	dej
dek	dek
del	del
dem	dem
den	den
deo	deo
dep	dep
deq	deq
der	der
des	des
det	det
deu	deu
dev	dev
dew	dew
dex	dex
dey	dey
dez	dez
dfa	dfa
dfb	dfb
dfc	dfc
dfd	dfd
dfe	dfe
dff	dff
dfg	dfg
dfh	dfh
dfi	dfi
dfj	dfj
dfk	dfk
dfl	dfl
dfm	dfm
dfn	dfn
dfo	dfo
dfp	dfp
dfq	dfq
dfr	dfr
dfs	dfs
dft	dft
dfu	dfu
dfv	dfv
dfw	dfw
dfx	dfx
dfy	dfy
dfz	dfz
dga	dga
dgb	dgb
dgc	dgc
dgd	dgd
dge	dge
dgf	dgf
dgg	dgg
dgh	dgh
dgi	dgi
dgj	dgj
dgk	dgk
dgl	dgl
dgm	dgm
dgn	dgn
dgo	dgo
dgp	dgp
dgq	dgq
dgr	dgr
dgs	dgs
dgt	dgt
dgu	dgu
dgv	dgv
dgw	dgw
dgx	dgx
dgy	dgy
dgz	dgz
dha	dha
dhb	dhb
dhc	dhc
dhd	dhd
dhe	dhe
dhf	dhf
dhg	dhg
dhh	dhh
dhi	dhi
dhj	dhj
dhk	dhk
dhl	dhl
dhm	dhm
dhn	dhn
dho	dho
dhp	dhp
dhq	dhq
dhr	dhr
dhs	dhs
dht	dht
dhu	dhu
dhv	dhv
dhw	dhw
dhx	dhx
dhy	dhy
dhz	dhz
dia	dia
dib	dib
dic	dic
did	did
die	die
dif	dif
dig	dig
dih	dih
dii	dii
dij	dij
dik	dik
dil	dil
dim	dim
din	din
dio	dio
dip	dip
diq	diq
dir	dir
dis	dis
dit	dit
diu	diu
div	div
diw	diw
dix	dix
diy	diy
diz	diz
dja	dja
djb	djb
djc	djc
djd	djd
dje	dje
djf	djf
djg	djg
djh	djh
dji	dji
djj	djj
djk	djk
djl	djl
djm	djm
djn	djn
djo	djo
djp	djp
djq	djq
djr	djr
djs	djs
djt	djt
dju	dju
djv	djv
djw	djw
djx	djx
djy	djy
djz	djz
dka	dka
dkb	dkb
dkc	dkc
dkd	dkd
dke	dke
dkf	dkf
dkg	dkg
dkh	dkh
dki	dki
dkj	dkj
dkk	dkk
dkl	dkl
dkm	dkm
dkn	dkn
dko	dko
dkp	dkp
dkq	dkq
dkr	dkr
dks	dks
dkt	dkt
dku	dku
dkv	dkv
dkw	dkw
dkx	dkx
dky	dky
dkz	dkz
dla	dla
dlb	dlb
dlc	dlc
dld	dld
dle	dle
dlf	dlf
dlg	dlg
dlh	dlh
dli	dli
dlj	dlj
dlk	dlk
dll	dll
dlm	dlm
dln	dln
dlo	dlo
dlp	dlp
dlq	dlq
dlr	dlr
dls	dls
dlt	dlt
dlu	dlu
dlv	dlv
dlw	dlw
dlx	dlx
dly	dly
dlz	dlz
dma	dma
dmb	dmb
dmc	dmc
dmd	dmd
dme	dme
dmf	dmf
dmg	dmg
dmh	dmh
dmi	dmi
dmj	dmj
dmk	dmk
dml	dml
dmm	dmm
dmn	dmn
dmo	dmo
dmp	dmp
dmq	dmq
dmr	dmr
dms	dms
dmt	dmt
dmu	dmu
dmv	dmv
dmw	dmw
dmx	dmx
dmy	dmy
dmz	dmz
dna	dna
dnb	dnb
dnc	dnc
dnd	dnd
dne	dne
dnf	dnf
dng	dng
dnh	dnh
dni	dni
dnj	dnj
dnk	dnk
dnl	dnl
dnm	dnm
dnn	dnn
dno	dno
dnp	dnp
dnq	dnq
dnr	dnr
dns	dns
dnt	dnt
dnu	dnu
dnv	dnv
dnw	dnw
dnx	dnx
dny	dny
dnz	dnz
doa	doa
dob	dob
doc	doc
dod	dod
doe	doe
dof	dof
dog	dog
doh	doh
doi	doi
doj	doj
dok	dok
dol	dol
dom	dom
don	don
doo	doo
dop	dop
doq	doq
dor	dor
dos	dos
dot	dot
dou	dou
dov	dov
dow	dow
dox	dox
doy	doy
doz	doz
dpa	dpa
dpb	dpb
dpc	dpc
dpd	dpd
dpe	dpe
dpf	dpf
dpg	dpg
dph	dph
dpi	dpi
dpj	dpj
dpk	dpk
dpl	dpl
dpm	dpm
dpn	dpn
dpo	dpo
dpp	dpp
dpq	dpq
dpr	dpr
dps	dps
dpt	dpt
dpu	dpu
dpv	dpv
dpw	dpw
dpx	dpx
dpy	dpy
dpz	dpz
dqa	dqa
dqb	dqb
dqc	dqc
dqd	dqd
dqe	dqe
dqf	dqf
dqg	dqg
dqh	dqh
dqi	dqi
dqj	dqj
dqk	dqk
dql	dql
dqm	dqm
dqn	dqn
dqo	dqo
dqp	dqp
dqq	dqq
dqr	dqr
dqs	dqs
dqt	dqt
dqu	dqu
dqv	dqv
dqw	dqw
dqx	dqx
dqy	dqy
dqz	dqz
dra	dra
drb	drb
drc	drc
drd	drd
dre	dre
drf	drf
drg	drg
drh	drh
dri	dri
drj	drj
drk	drk
drl	drl
drm	drm
drn	drn
dro	dro
drp	drp
drq	drq
drr	drr
drs	drs
drt	drt
dru	dru
drv	drv
drw	drw
drx	drx
dry	dry
drz	drz
dsa	dsa
dsb	dsb
dsc	dsc
dsd	dsd
dse	dse
dsf	dsf
dsg	dsg
dsh	dsh
dsi	dsi
dsj	dsj
dsk	dsk
dsl	dsl
dsm	dsm
dsn	dsn
dso	dso
dsp	dsp
dsq	dsq
dsr	dsr
dss	dss
dst	dst
dsu	dsu
dsv	dsv
dsw	dsw
dsx	dsx
dsy	dsy
dsz	dsz
dta	dta
dtb	dtb
dtc	dtc
dtd	dtd
dte	dte
dtf	dtf
dtg	dtg
dth	dth
dti	dti
dtj	dtj
dtk	dtk
dtl	dtl
dtm	dtm
dtn	dtn
dto	dto
dtp	dtp
dtq	dtq
dtr	dtr
dts	dts
dtt	dtt
dtu	dtu
dtv	dtv
dtw	dtw
dtx	dtx
dty	dty
dtz	dtz
dua	dua
dub	dub
duc	duc
dud	dud
due	due
duf	duf
dug	dug
duh	duh
dui	dui
duj	duj
duk	duk
dul	dul
dum	dum
dun	dun
duo	duo
dup	dup
duq	duq
dur	dur
dus	dus
dut	dut
duu	duu
duv	duv
duw	duw
dux	dux
duy	duy
duz	duz
dva	dva
dvb	dvb
dvc	dvc
dvd	dvd
dve	dve
dvf	dvf
dvg	dvg
dvh	dvh
dvi	dvi
dvj	dvj
dvk	dvk
dvl	dvl
dvm	dvm
dvn	dvn
dvo	dvo
dvp	dvp
dvq	dvq
dvr	dvr
dvs	dvs
dvt	dvt
dvu	dvu
dvv	dvv
dvw	dvw
dvx	dvx
dvy	dvy
dvz	dvz
dwa	dwa
dwb	dwb
dwc	dwc
dwd	dwd
dwe	dwe
dwf	dwf
dwg	dwg
dwh	dwh
dwi	dwi
dwj	dwj
dwk	dwk
dwl	dwl
dwm	dwm
dwn	dwn
dwo	dwo
dwp	dwp
dwq	dwq
dwr	dwr
dws	dws
dwt	dwt
dwu	dwu
dwv	dwv
dww	dww
dwx	dwx
dwy	dwy
dwz	dwz
dxa	dxa
dxb	dxb
dxc	dxc
dxd	dxd
dxe	dxe
dxf	dxf
dxg	dxg
dxh	dxh
dxi	dxi
dxj	dxj
dxk	dxk
dxl	dxl
dxm	dxm
dxn	dxn
dxo	dxo
dxp	dxp
dxq	dxq
dxr	dxr
dxs	dxs
dxt	dxt
dxu	dxu
dxv	dxv
dxw	dxw
dxx	dxx
dxy	dxy
dxz	dxz
dya	dya
dyb	dyb
dyc	dyc
dyd	dyd
dye	dye
dyf	dyf
dyg	dyg
dyh	dyh
dyi	dyi
dyj	dyj
dyk	dyk
dyl	dyl
dym	dym
dyn	dyn
dyo	dyo
dyp	dyp
dyq	dyq
dyr	dyr
dys	dys
dyt	dyt
dyu	dyu
dyv	dyv
dyw	dyw
dyx	dyx
dyy	dyy
dyz	dyz
dza	dza
dzb	dzb
dzc	dzc
dzd	dzd
dze	dze
dzf	dzf
dzg	dzg
dzh	dzh
dzi	dzi
dzj	dzj
dzk	dzk
dzl	dzl
dzm	dzm
dzn	dzn
dzo	dzo
dzp	dzp
dzq	dzq
dzr	dzr
dzs	dzs
dzt	dzt
dzu	dzu
dzv	dzv
dzw	dzw
dzx	dzx
dzy	dzy
dzz	dzz
eaa	eaa
eab	eab
eac	eac
ead	ead
eae	eae
eaf	eaf
eag	eag
eah	eah
eai	eai
eaj	eaj
eak	eak
eal	eal
eam	eam
ean	ean
eao	eao
eap	eap
eaq	eaq
ear	ear
eas	eas
eat	eat
eau	eau
eav	eav
eaw	eaw
eax	eax
eay	eay
eaz	eaz
eba	eba
ebb	ebb
ebc	ebc
ebd	ebd
ebe	ebe
ebf	ebf
ebg	ebg
ebh	ebh
ebi	ebi
ebj	ebj
ebk	ebk
ebl	ebl
ebm	ebm
ebn	ebn
ebo	ebo
ebp	ebp
ebq	ebq
ebr	ebr
ebs	ebs
ebt	ebt
ebu	ebu
ebv	ebv
ebw	ebw
ebx	ebx
eby	eby
ebz	ebz
eca	eca
ecb	ecb
ecc	ecc
ecd	ecd
ece	ece
ecf	ecf
ecg	ecg
ech	ech
eci	eci
ecj	ecj
eck	eck
ecl	ecl
ecm	ecm
ecn	ecn
eco	eco
ecp	ecp
ecq	ecq
ecr	ecr
ecs	ecs
ect	ect
ecu	ecu
ecv	ecv
ecw	ecw
ecx	ecx
ecy	ecy
ecz	ecz
eda	eda
edb	edb
edc	edc
edd	edd
ede	ede
edf	edf
edg	edg
edh	edh
edi	edi
edj	edj
edk	edk
edl	edl
edm	edm
edn	edn
edo	edo
edp	edp
edq	edq
edr	edr
eds	eds
edt	edt
edu	edu
edv	edv
edw	edw
edx	edx
edy	edy
edz	edz
eea	eea
eeb	eeb
eec	eec
eed	eed
eee	eee
eef	eef
eeg	eeg
eeh	eeh
eei	eei
eej	eej
eek	eek
eel	eel
eem	eem
een	een
eeo	eeo
eep	eep
eeq	eeq
eer	eer
ees	ees
eet	eet
eeu	eeu
eev	eev
eew	eew
eex	eex
eey	eey
eez	eez
efa	efa
efb	efb
efc	efc
efd	efd
efe	efe
eff	eff
efg	efg
efh	efh
efi	efi
efj	efj
efk	efk
efl	efl
efm	efm
efn	efn
efo	efo
efp	efp
efq	efq
efr	efr
efs	efs
eft	eft
efu	efu
efv	efv
efw	efw
efx	efx
efy	efy
efz	efz
ega	ega
egb	egb
egc	egc
egd	egd
ege	ege
egf	egf
egg	egg
egh	egh
egi	egi
egj	egj
egk	egk
egl	egl
egm	egm
egn	egn
ego	ego
egp	egp
egq	egq
egr	egr
egs	egs
egt	egt
egu	egu
egv	egv
egw	egw
egx	egx
egy	egy
egz	egz
eha	eha
ehb	ehb
ehc	ehc
ehd	ehd
ehe	ehe
ehf	ehf
ehg	ehg
ehh	ehh
ehi	ehi
ehj	ehj
ehk	ehk
ehl	ehl
ehm	ehm
ehn	ehn
eho	eho
ehp	ehp
ehq	ehq
ehr	ehr
ehs	ehs
eht	eht
ehu	ehu
ehv	ehv
ehw	ehw
ehx	ehx
ehy	ehy
ehz	ehz
eia	eia
eib	eib
eic	eic
eid	eid
eie	eie
eif	eif
eig	eig
eih	eih
eii	eii
eij	eij
eik	eik
eil	eil
eim	eim
ein	ein
eio	eio
eip	eip
eiq	eiq
eir	eir
eis	eis
eit	eit
eiu	eiu
eiv	eiv
eiw	eiw
eix	eix
eiy	eiy
eiz	eiz
eja	eja
ejb	ejb
ejc	ejc
ejd	ejd
eje	eje
ejf	ejf
ejg	ejg
ejh	ejh
eji	eji
ejj	ejj
ejk	ejk
ejl	ejl
ejm	ejm
ejn	ejn
ejo	ejo
ejp	ejp
ejq	ejq
ejr	ejr
ejs	ejs
ejt	ejt
eju	eju
ejv	ejv
ejw	ejw
ejx	ejx
ejy	ejy
ejz	ejz
eka	eka
ekb	ekb
ekc	ekc
ekd	ekd
eke	eke
ekf	ekf
ekg	ekg
ekh	ekh
eki	eki
ekj	ekj
ekk	ekk
ekl	ekl
ekm	ekm
ekn	ekn
eko	eko
ekp	ekp
ekq	ekq
ekr	ekr
eks	eks
ekt	ekt
eku	eku
ekv	ekv
ekw	ekw
ekx	ekx
eky	eky
ekz	ekz
ela	ela
elb	elb
elc	elc
eld	eld
ele	ele
elf	elf
elg	elg
elh	elh
eli	eli
elj	elj
elk	elk
ell	ell
elm	elm
eln	eln
elo	elo
elp	elp
elq	elq
elr	elr
els	els
elt	elt
elu	elu
elv	elv
elw	elw
elx	elx
ely	ely
elz	elz
ema	ema
emb	emb
emc	emc
emd	emd
eme	eme
emf	emf
emg	emg
emh	emh
emi	emi
emj	emj
emk	emk
eml	eml
emm	emm
emn	emn
emo	emo
emp	emp
emq	emq
emr	emr
ems	ems
emt	emt
emu	emu
emv	emv
emw	emw
emx	emx
emy	emy
emz	emz
ena	ena
enb	enb
enc	enc
end	end
ene	ene
enf	enf
eng	eng
enh	enh
eni	eni
enj	enj
enk	enk
enl	enl
enm	enm
enn	enn
eno	eno
enp	enp
enq	enq
enr	enr
ens	ens
ent	ent
enu	enu
env	env
enw	enw
enx	enx
eny	eny
enz	enz
eoa	eoa
eob	eob
eoc	eoc
eod	eod
eoe	eoe
eof	eof
eog	eog
eoh	eoh
eoi	eoi
eoj	eoj
eok	eok
eol	eol
eom	eom
eon	eon
eoo	eoo
eop	eop
eoq	eoq
eor	eor
eos	eos
eot	eot
eou	eou
eov	eov
eow	eow
eox	eox
eoy	eoy
eoz	eoz
epa	epa
epb	epb
epc	epc
epd	epd
epe	epe
epf	epf
epg	epg
eph	eph
epi	epi
epj	epj
epk	epk
epl	epl
epm	epm
epn	epn
epo	epo
epp	epp
epq	epq
epr	epr
eps	eps
ept	ept
epu	epu
epv	epv
epw	epw
epx	epx
epy	epy
epz	epz
eqa	eqa
eqb	eqb
eqc	eqc
eqd	eqd
eqe	eqe
eqf	eqf
eqg	eqg
eqh	eqh
eqi	eqi
eqj	eqj
eqk	eqk
eql	eql
eqm	eqm
eqn	eqn
eqo	eqo
eqp	eqp
eqq	eqq
eqr	eqr
eqs	eqs
eqt	eqt
equ	equ
eqv	eqv
eqw	eqw
eqx	eqx
eqy	eqy
eqz	eqz
era	era
erb	erb
erc	erc
erd	erd
ere	ere
erf	erf
erg	erg
erh	erh
eri	eri
erj	erj
erk	erk
erl	erl
erm	erm
ern	ern
ero	ero
erp	erp
erq	erq
err	err
ers	ers
ert	ert
eru	eru
erv	erv
erw	erw
erx	erx
ery	ery
erz	erz
esa	esa
esb	esb
esc	esc
esd	esd
ese	ese
esf	esf
esg	esg
esh	esh
esi	esi
esj	esj
esk	esk
esl	esl
esm	esm
esn	esn
eso	eso
esp	esp
esq	esq
esr	esr
ess	ess
est	est
esu	esu
esv	esv
esw	esw
esx	esx
esy	esy
esz	esz
eta	eta
etb	etb
etc	etc
etd	etd
ete	ete
etf	etf
etg	etg
eth	eth
eti	eti
etj	etj
etk	etk
etl	etl
etm	etm
etn	etn
eto	eto
etp	etp
etq	etq
etr	etr
ets	ets
ett	ett
etu	etu
etv	etv
etw	etw
etx	etx
ety	ety
etz	etz
eua	eua
eub	eub
euc	euc
eud	eud
eue	eue
euf	euf
eug	eug
euh	euh
eui	eui
euj	euj
euk	euk
eul	eul
eum	eum
eun	eun
euo	euo
eup	eup
euq	euq
eur	eur
eus	eus
eut	eut
euu	euu
euv	euv
euw	euw
eux	eux
euy	euy
euz	euz
eva	eva
evb	evb
evc	evc
evd	evd
eve	eve
evf	evf
evg	evg
evh	evh
evi	evi
evj	evj
evk	evk
evl	evl
evm	evm
evn	evn
evo	evo
evp	evp
evq	evq
evr	evr
evs	evs
evt	evt
evu	evu
evv	evv
evw	evw
evx	evx
evy	evy
evz	evz
ewa	ewa
ewb	ewb
ewc	ewc
ewd	ewd
ewe	ewe
ewf	ewf
ewg	ewg
ewh	ewh
ewi	ewi
ewj	ewj
ewk	ewk
ewl	ewl
ewm	ewm
ewn	ewn
ewo	ewo
ewp	ewp
ewq	ewq
ewr	ewr
ews	ews
ewt	ewt
ewu	ewu
ewv	ewv
eww	eww
ewx	ewx
ewy	ewy
ewz	ewz
exa	exa
exb	exb
exc	exc
exd	exd
exe	exe
exf	exf
exg	exg
exh	exh
exi	exi
exj	exj
exk	exk
exl	exl
exm	exm
exn	exn
exo	exo
exp	exp
exq	exq
exr	exr
exs	exs
ext	ext
exu	exu
exv	exv
exw	exw
exx	exx
exy	exy
exz	exz
eya	eya
eyb	eyb
eyc	eyc
eyd	eyd
eye	eye
eyf	eyf
eyg	eyg
eyh	eyh
eyi	eyi
eyj	eyj
eyk	eyk
eyl	eyl
eym	eym
eyn	eyn
eyo	eyo
eyp	eyp
eyq	eyq
eyr	eyr
eys	eys
eyt	eyt
eyu	eyu
eyv	eyv
eyw	eyw
eyx	eyx
eyy	eyy
eyz	eyz
eza	eza
ezb	ezb
ezc	ezc
ezd	ezd
eze	eze
ezf	ezf
ezg	ezg
ezh	ezh
ezi	ezi
ezj	ezj
ezk	ezk
ezl	ezl
ezm	ezm
ezn	ezn
ezo	ezo
ezp	ezp
ezq	ezq
ezr	ezr
ezs	ezs
ezt	ezt
ezu	ezu
ezv	ezv
ezw	ezw
ezx	ezx
ezy	ezy
ezz	ezz
faa	faa
fab	fab
fac	fac
fad	fad
fae	fae
faf	faf
fag	fag
fah	fah
fai	fai
faj	faj
fak	fak
fal	fal
fam	fam
fan	fan
fao	fao
fap	fap
faq	faq
far	far
fas	fas
fat	fat
fau	fau
fav	fav
faw	faw
fax	fax
fay	fay
faz	faz
fba	fba
fbb	fbb
fbc	fbc
fbd	fbd
fbe	fbe
fbf	fbf
fbg	fbg
fbh	fbh
fbi	fbi
fbj	fbj
fbk	fbk
fbl	fbl
fbm	fbm
fbn	fbn
fbo	fbo
fbp	fbp
fbq	fbq
fbr	fbr
fbs	fbs
fbt	fbt
fbu	fbu
fbv	fbv
fbw	fbw
fbx	fbx
fby	fby
fbz	fbz
fca	fca
fcb	fcb
fcc	fcc
fcd	fcd
fce	fce
fcf	fcf
fcg	fcg
fch	fch
fci	fci
fcj	fcj
fck	fck
fcl	fcl
fcm	fcm
fcn	fcn
fco	fco
fcp	fcp
fcq	fcq
fcr	fcr
fcs	fcs
fct	fct
fcu	fcu
fcv	fcv
fcw	fcw
fcx	fcx
fcy	fcy
fcz	fcz
fda	fda
fdb	fdb
fdc	fdc
fdd	fdd
fde	fde
fdf	fdf
fdg	fdg
fdh	fdh
fdi	fdi
fdj	fdj
fdk	fdk
fdl	fdl
fdm	fdm
fdn	fdn
fdo	fdo
fdp	fdp
fdq	fdq
fdr	fdr
fds	fds
fdt	fdt
fdu	fdu
fdv	fdv
fdw	fdw
fdx	fdx
fdy	fdy
fdz	fdz
fea	fea
feb	feb
fec	fec
fed	fed
fee	fee
fef	fef
feg	feg
feh	feh
fei	fei
fej	fej
fek	fek
fel	fel
fem	fem
fen	fen
feo	feo
fep	fep
feq	feq
fer	fer
fes	fes
fet	fet
feu	feu
fev	fev
few	few
fex	fex
fey	fey
fez	fez
ffa	ffa
ffb	ffb
ffc	ffc
ffd	ffd
ffe	ffe
fff	fff
ffg	ffg
ffh	ffh
ffi	ffi
ffj	ffj
ffk	ffk
ffl	ffl
ffm	ffm
ffn	ffn
ffo	ffo
ffp	ffp
ffq	ffq
ffr	ffr
ffs	ffs
fft	fft
ffu	ffu
ffv	ffv
ffw	ffw
ffx	ffx
ffy	ffy
ffz	ffz
fga	fga
fgb	fgb
fgc	fgc
fgd	fgd
fge	fge
fgf	fgf
fgg	fgg
fgh	fgh
fgi	fgi
fgj	fgj
fgk	fgk
fgl	fgl
fgm	fgm
fgn	fgn
fgo	fgo
fgp	fgp
fgq	fgq
fgr	fgr
fgs	fgs
fgt	fgt
fgu	fgu
fgv	fgv
fgw	fgw
fgx	fgx
fgy	fgy
fgz	fgz
fha	fha
fhb	fhb
fhc	fhc
fhd	fhd
fhe	fhe
fhf	fhf
fhg	fhg
fhh	fhh
fhi	fhi
fhj	fhj
fhk	fhk
fhl	fhl
fhm	fhm
fhn	fhn
fho	fho
fhp	fhp
fhq	fhq
fhr	fhr
fhs	fhs
fht	fht
fhu	fhu
fhv	fhv
fhw	fhw
fhx	fhx
fhy	fhy
fhz	fhz
fia	fia
fib	fib
fic	fic
fid	fid
fie	fie
fif	fif
fig	fig
fih	fih
fii	fii
fij	fij
fik	fik
fil	fil
fim	fim
fin	fin
fio	fio
fip	fip
fiq	fiq
fir	fir
fis	fis
fit	fit
fiu	fiu
fiv	fiv
fiw	fiw
fix	fix
fiy	fiy
fiz	fiz
fja	fja
fjb	fjb
fjc	fjc
fjd	fjd
fje	fje
fjf	fjf
fjg	fjg
fjh	fjh
fji	fji
fjj	fjj
fjk	fjk
fjl	fjl
fjm	fjm
fjn	fjn
fjo	fjo
fjp	fjp
fjq	fjq
fjr	fjr
fjs	fjs
fjt	fjt
fju	fju
fjv	fjv
fjw	fjw
fjx	fjx
fjy	fjy
fjz	fjz
fka	fka
fkb	fkb
fkc	fkc
fkd	fkd
fke	fke
fkf	fkf
fkg	fkg
fkh	fkh
fki	fki
fkj	fkj
fkk	fkk
fkl	fkl
fkm	fkm
fkn	fkn
fko	fko
fkp	fkp
fkq	fkq
fkr	fkr
fks	fks
fkt	fkt
fku	fku
fkv	fkv
fkw	fkw
fkx	fkx
fky	fky
fkz	fkz
fla	fla
flb	flb
flc	flc
fld	fld
fle	fle
flf	flf
flg	flg
flh	flh
fli	fli
flj	flj
flk	flk
fll	fll
flm	flm
fln	fln
flo	flo
flp	flp
flq	flq
flr	flr
fls	fls
flt	flt
flu	flu
flv	flv
flw	flw
flx	flx
fly	fly
flz	flz
fma	fma
fmb	fmb
fmc	fmc
fmd	fmd
fme	fme
fmf	fmf
fmg	fmg
fmh	fmh
fmi	fmi
fmj	fmj
fmk	fmk
fml	fml
fmm	fmm
fmn	fmn
fmo	fmo
fmp	fmp
fmq	fmq
fmr	fmr
fms	fms
fmt	fmt
fmu	fmu
fmv	fmv
fmw	fmw
fmx	fmx
fmy	fmy
fmz	fmz
fna	fna
fnb	fnb
fnc	fnc
fnd	fnd
fne	fne
fnf	fnf
fng	fng
fnh	fnh
fni	fni
fnj	fnj
fnk	fnk
fnl	fnl
fnm	fnm
fnn	fnn
fno	fno
fnp	fnp
fnq	fnq
fnr	fnr
fns	fns
fnt	fnt
fnu	fnu
fnv	fnv
fnw	fnw
fnx	fnx
fny	fny
fnz	fnz
foa	foa
fob	fob
foc	foc
fod	fod
foe	foe
fof	fof
fog	fog
foh	foh
foi	foi
foj	foj
fok	fok
fol	fol
fom	fom
fon	fon
foo	foo
fop	fop
foq	foq
for	for
fos	fos
fot	fot
fou	fou
fov	fov
fow	fow
fox	fox
foy	foy
foz	foz
fpa	fpa
fpb	fpb
fpc	fpc
fpd	fpd
fpe	fpe
fpf	fpf
fpg	fpg
fph	fph
fpi	fpi
fpj	fpj
fpk	fpk
fpl	fpl
fpm	fpm
fpn	fpn
fpo	fpo
fpp	fpp
fpq	fpq
fpr	fpr
fps	fps
fpt	fpt
fpu	fpu
fpv	fpv
fpw	fpw
fpx	fpx
fpy	fpy
fpz	fpz
fqa	fqa
fqb	fqb
fqc	fqc
fqd	fqd
fqe	fqe
fqf	fqf
fqg	fqg
fqh	fqh
fqi	fqi
fqj	fqj
fqk	fqk
fql	fql
fqm	fqm
fqn	fqn
fqo	fqo
fqp	fqp
fqq	fqq
fqr	fqr
fqs	fqs
fqt	fqt
fqu	fqu
fqv	fqv
fqw	fqw
fqx	fqx
fqy	fqy
fqz	fqz
fra	fra
frb	frb
frc	frc
frd	frd
fre	fre
frf	frf
frg	frg
frh	frh
fri	fri
frj	frj
frk	frk
frl	frl
frm	frm
frn	frn
fro	fro
frp	frp
frq	frq
frr	frr
frs	frs
frt	frt
fru	fru
frv	frv
frw	frw
frx	frx
fry	fry
frz	frz
fsa	fsa
fsb	fsb
fsc	fsc
fsd	fsd
fse	fse
fsf	fsf
fsg	fsg
fsh	fsh
fsi	fsi
fsj	fsj
fsk	fsk
fsl	fsl
fsm	fsm
fsn	fsn
fso	fso
fsp	fsp
fsq	fsq
fsr	fsr
fss	fss
fst	fst
fsu	fsu
fsv	fsv
fsw	fsw
fsx	fsx
fsy	fsy
fsz	fsz
fta	fta
ftb	ftb
ftc	ftc
ftd	ftd
fte	fte
ftf	ftf
ftg	ftg
fth	fth
fti	fti
ftj	ftj
ftk	ftk
ftl	ftl
ftm	ftm
ftn	ftn
fto	fto
ftp	ftp
ftq	ftq
ftr	ftr
fts	fts
ftt	ftt
ftu	ftu
ftv	ftv
ftw	ftw
ftx	ftx
fty	fty
ftz	ftz
fua	fua
fub	fub
fuc	fuc
fud	fud
fue	fue
fuf	fuf
fug	fug
fuh	fuh
fui	fui
fuj	fuj
fuk	fuk
ful	ful
fum	fum
fun	fun
fuo	fuo
fup	fup
fuq	fuq
fur	fur
fus	fus
fut	fut
fuu	fuu
fuv	fuv
fuw	fuw
fux	fux
fuy	fuy
fuz	fuz
fva	fva
fvb	fvb
fvc	fvc
fvd	fvd
fve	fve
fvf	fvf
fvg	fvg
fvh	fvh
fvi	fvi
fvj	fvj
fvk	fvk
fvl	fvl
fvm	fvm
fvn	fvn
fvo	fvo
fvp	fvp
fvq	fvq
fvr	fvr
fvs	fvs
fvt	fvt
fvu	fvu
fvv	fvv
fvw	fvw
fvx	fvx
fvy	fvy
fvz	fvz
fwa	fwa
fwb	fwb
fwc	fwc
fwd	fwd
fwe	fwe
fwf	fwf
fwg	fwg
fwh	fwh
fwi	fwi
fwj	fwj
fwk	fwk
fwl	fwl
fwm	fwm
fwn	fwn
fwo	fwo
fwp	fwp
fwq	fwq
fwr	fwr
fws	fws
fwt	fwt
fwu	fwu
fwv	fwv
fww	fww
fwx	fwx
fwy	fwy
fwz	fwz
fxa	fxa
fxb	fxb
fxc	fxc
fxd	fxd
fxe	fxe
fxf	fxf
fxg	fxg
fxh	fxh
fxi	fxi
fxj	fxj
fxk	fxk
fxl	fxl
fxm	fxm
fxn	fxn
fxo	fxo
fxp	fxp
fxq	fxq
fxr	fxr
fxs	fxs
fxt	fxt
fxu	fxu
fxv	fxv
fxw	fxw
fxx	fxx
fxy	fxy
fxz	fxz
fya	fya
fyb	fyb
fyc	fyc
fyd	fyd
fye	fye
fyf	fyf
fyg	fyg
fyh	fyh
fyi	fyi
fyj	fyj
fyk	fyk
fyl	fyl
fym	fym
fyn	fyn
fyo	fyo
fyp	fyp
fyq	fyq
fyr	fyr
fys	fys
fyt	fyt
fyu	fyu
fyv	fyv
fyw	fyw
fyx	fyx
fyy	fyy
fyz	fyz
fza	fza
fzb	fzb
fzc	fzc
fzd	fzd
fze	fze
fzf	fzf
fzg	fzg
fzh	fzh
fzi	fzi
fzj	fzj
fzk	fzk
fzl	fzl
fzm	fzm
fzn	fzn
fzo	fzo
fzp	fzp
fzq	fzq
fzr	fzr
fzs	fzs
fzt	fzt
fzu	fzu
fzv	fzv
fzw	fzw
fzx	fzx
fzy	fzy
fzz	fzz
gaa	gaa
gab	gab
gac	gac
gad	gad
gae	gae
gaf	gaf
gag	gag
gah	gah
gai	gai
gaj	gaj
gak	gak
gal	gal
gam	gam
gan	gan
gao	gao
gap	gap
gaq	gaq
gar	gar
gas	gas
gat	gat
gau	gau
gav	gav
gaw	gaw
gax	gax
gay	gay
gaz	gaz
gba	gba
gbb	gbb
gbc	gbc
gbd	gbd
gbe	gbe
gbf	gbf
gbg	gbg
gbh	gbh
gbi	gbi
gbj	gbj
gbk	gbk
gbl	gbl
gbm	gbm
gbn	gbn
gbo	gbo
gbp	gbp
gbq	gbq
gbr	gbr
gbs	gbs
gbt	gbt
gbu	gbu
gbv	gbv
gbw	gbw
gbx	gbx
gby	gby
gbz	gbz
gca	gca
gcb	gcb
gcc	gcc
gcd	gcd
gce	gce
gcf	gcf
gcg	gcg
gch	gch
gci	gci
gcj	gcj
gck	gck
gcl	gcl
gcm	gcm
gcn	gcn
gco	gco
gcp	gcp
gcq	gcq
gcr	gcr
gcs	gcs
gct	gct
gcu	gcu
gcv	gcv
gcw	gcw
gcx	gcx
gcy	gcy
gcz	gcz
gda	gda
gdb	gdb
gdc	gdc
gdd	gdd
gde	gde
gdf	gdf
gdg	gdg
gdh	gdh
gdi	gdi
gdj	gdj
gdk	gdk
gdl	gdl
gdm	gdm
gdn	gdn
gdo	gdo
gdp	gdp
gdq	gdq
gdr	gdr
gds	gds
gdt	gdt
gdu	gdu
gdv	gdv
gdw	gdw
gdx	gdx
gdy	gdy
gdz	gdz
gea	gea
geb	geb
gec	gec
ged	ged
gee	gee
gef	gef
geg	geg
geh	geh
gei	gei
gej	gej
gek	gek
gel	gel
gem	gem
gen	gen
geo	geo
gep	gep
geq	geq
ger	ger
ges	ges
get	get
geu	geu
gev	gev
gew	gew
gex	gex
gey	gey
gez	gez
gfa	gfa
gfb	gfb
gfc	gfc
gfd	gfd
gfe	gfe
gff	gff
gfg	gfg
gfh	gfh
gfi	gfi
gfj	gfj
gfk	gfk
gfl	gfl
gfm	gfm
gfn	gfn
gfo	gfo
gfp	gfp
gfq	gfq
gfr	gfr
gfs	gfs
gft	gft
gfu	gfu
gfv	gfv
gfw	gfw
gfx	gfx
gfy	gfy
gfz	gfz
gga	gga
ggb	ggb
ggc	ggc
ggd	ggd
gge	gge
ggf	ggf
ggg	ggg
ggh	ggh
ggi	ggi
ggj	ggj
ggk	ggk
ggl	ggl
ggm	ggm
ggn	ggn
ggo	ggo
ggp	ggp
ggq	ggq
ggr	ggr
ggs	ggs
ggt	ggt
ggu	ggu
ggv	ggv
ggw	ggw
ggx	ggx
ggy	ggy
ggz	ggz
gha	gha
ghb	ghb
ghc	ghc
ghd	ghd
ghe	ghe
ghf	ghf
ghg	ghg
ghh	ghh
ghi	ghi
ghj	ghj
ghk	ghk
ghl	ghl
ghm	ghm
ghn	ghn
gho	gho
ghp	ghp
ghq	ghq
ghr	ghr
ghs	ghs
ght	ght
ghu	ghu
ghv	ghv
ghw	ghw
ghx	ghx
ghy	ghy
ghz	ghz
gia	gia
gib	gib
gic	gic
gid	gid
gie	gie
gif	gif
gig	gig
gih	gih
gii	gii
gij	gij
gik	gik
gil	gil
gim	gim
gin	gin
gio	gio
gip	gip
giq	giq
gir	gir
gis	gis
git	git
giu	giu
giv	giv
giw	giw
gix	gix
giy	giy
giz	giz
gja	gja
gjb	gjb
gjc	gjc
gjd	gjd
gje	gje
gjf	gjf
gjg	gjg
gjh	gjh
gji	gji
gjj	gjj
gjk	gjk
gjl	gjl
gjm	gjm
gjn	gjn
gjo	gjo
gjp	gjp
gjq	gjq
gjr	gjr
gjs	gjs
gjt	gjt
gju	gju
gjv	gjv
gjw	gjw
gjx	gjx
gjy	gjy
gjz	gjz
gka	gka
gkb	gkb
gkc	gkc
gkd	gkd
gke	gke
gkf	gkf
gkg	gkg
gkh	gkh
gki	gki
gkj	gkj
gkk	gkk
gkl	gkl
gkm	gkm
gkn	gkn
gko	gko
gkp	gkp
gkq	gkq
gkr	gkr
gks	gks
gkt	gkt
gku	gku
gkv	gkv
gkw	gkw
gkx	gkx
gky	gky
gkz	gkz
gla	gla
glb	glb
glc	glc
gld	gld
gle	gle
glf	glf
glg	glg
glh	glh
gli	gli
glj	glj
glk	glk
gll	gll
glm	glm
gln	gln
glo	glo
glp	glp
glq	glq
glr	glr
gls	gls
glt	glt
glu	glu
glv	glv
glw	glw
glx	glx
gly	gly
glz	glz
gma	gma
gmb	gmb
gmc	gmc
gmd	gmd
gme	gme
gmf	gmf
gmg	gmg
gmh	gmh
gmi	gmi
gmj	gmj
gmk	gmk
gml	gml
gmm	gmm
gmn	gmn
gmo	gmo
gmp	gmp
gmq	gmq
gmr	gmr
gms	gms
gmt	gmt
gmu	gmu
gmv	gmv
gmw	gmw
gmx	gmx
gmy	gmy
gmz	gmz
gna	gna
gnb	gnb
gnc	gnc
gnd	gnd
gne	gne
gnf	gnf
gng	gng
gnh	gnh
gni	gni
gnj	gnj
gnk	gnk
gnl	gnl
gnm	gnm
gnn	gnn
gno	gno
gnp	gnp
gnq	gnq
gnr	gnr
gns	gns
gnt	gnt
gnu	gnu
gnv	gnv
gnw	gnw
gnx	gnx
gny	gny
gnz	gnz
goa	goa
gob	gob
goc	goc
god	god
goe	goe
gof	gof
gog	gog
goh	goh
goi	goi
goj	goj
gok	gok
gol	gol
gom	gom
gon	gon
goo	goo
gop	gop
goq	goq
gor	gor
gos	gos
got	got
gou	gou
gov	gov
gow	gow
gox	gox
goy	goy
goz	goz
gpa	gpa
gpb	gpb
gpc	gpc
gpd	gpd
gpe	gpe
gpf	gpf
gpg	gpg
gph	gph
gpi	gpi
gpj	gpj
gpk	gpk
gpl	gpl
gpm	gpm
gpn	gpn
gpo	gpo
gpp	gpp
gpq	gpq
gpr	gpr
gps	gps
gpt	gpt
gpu	gpu
gpv	gpv
gpw	gpw
gpx	gpx
gpy	gpy
gpz	gpz
gqa	gqa
gqb	gqb
gqc	gqc
gqd	gqd
gqe	gqe
gqf	gqf
gqg	gqg
gqh	gqh
gqi	gqi
gqj	gqj
gqk	gqk
gql	gql
gqm	gqm
gqn	gqn
gqo	gqo
gqp	gqp
gqq	gqq
gqr	gqr
gqs	gqs
gqt	gqt
gqu	gqu
gqv	gqv
gqw	gqw
gqx	gqx
gqy	gqy
gqz	gqz
gra	gra
grb	grb
grc	grc
grd	grd
gre	gre
grf	grf
grg	grg
grh	grh
gri	gri
grj	grj
grk	grk
grl	grl
grm	grm
grn	grn
gro	gro
grp	grp
grq	grq
grr	grr
grs	grs
grt	grt
gru	gru
grv	grv
grw	grw
grx	grx
gry	gry
grz	grz
gsa	gsa
gsb	gsb
gsc	gsc
gsd	gsd
gse	gse
gsf	gsf
gsg	gsg
gsh	gsh
gsi	gsi
gsj	gsj
gsk	gsk
gsl	gsl
gsm	gsm
gsn	gsn
gso	gso
gsp	gsp
gsq	gsq
gsr	gsr
gss	gss
gst	gst
gsu	gsu
gsv	gsv
gsw	gsw
gsx	gsx
gsy	gsy
gsz	gsz
gta	gta
gtb	gtb
gtc	gtc
gtd	gtd
gte	gte
gtf	gtf
gtg	gtg
gth	gth
gti	gti
gtj	gtj
gtk	gtk
gtl	gtl
gtm	gtm
gtn	gtn
gto	gto
gtp	gtp
gtq	gtq
gtr	gtr
gts	gts
gtt	gtt
gtu	gtu
gtv	gtv
gtw	gtw
gtx	gtx
gty	gty
gtz	gtz
gua	gua
gub	gub
guc	guc
gud	gud
gue	gue
guf	guf
gug	gug
guh	guh
gui	gui
guj	guj
guk	guk
gul	gul
gum	gum
gun	gun
guo	guo
gup	gup
guq	guq
gur	gur
gus	gus
gut	gut
guu	guu
guv	guv
guw	guw
gux	gux
guy	guy
guz	guz
gva	gva
gvb	gvb
gvc	gvc
gvd	gvd
gve	gve
gvf	gvf
gvg	gvg
gvh	gvh
gvi	gvi
gvj	gvj
gvk	gvk
gvl	gvl
gvm	gvm
gvn	gvn
gvo	gvo
gvp	gvp
gvq	gvq
gvr	gvr
gvs	gvs
gvt	gvt
gvu	gvu
gvv	gvv
gvw	gvw
gvx	gvx
gvy	gvy
gvz	gvz
gwa	gwa
gwb	gwb
gwc	gwc
gwd	gwd
gwe	gwe
gwf	gwf
gwg	gwg
gwh	gwh
gwi	gwi
gwj	gwj
gwk	gwk
gwl	gwl
gwm	gwm
gwn	gwn
gwo	gwo
gwp	gwp
gwq	gwq
gwr	gwr
gws	gws
gwt	gwt
gwu	gwu
gwv	gwv
gww	gww
gwx	gwx
gwy	gwy
gwz	gwz
gxa	gxa
gxb	gxb
gxc	gxc
gxd	gxd
gxe	gxe
gxf	gxf
gxg	gxg
gxh	gxh
gxi	gxi
gxj	gxj
gxk	gxk
gxl	gxl
gxm	gxm
gxn	gxn
gxo	gxo
gxp	gxp
gxq	gxq
gxr	gxr
gxs	gxs
gxt	gxt
gxu	gxu
gxv	gxv
gxw	gxw
gxx	gxx
gxy	gxy
gxz	gxz
gya	gya
gyb	gyb
gyc	gyc
gyd	gyd
gye	gye
gyf	gyf
gyg	gyg
gyh	gyh
gyi	gyi
gyj	gyj
gyk	gyk
gyl	gyl
gym	gym
gyn	gyn
gyo	gyo
gyp	gyp
gyq	gyq
gyr	gyr
gys	gys
gyt	gyt
gyu	gyu
gyv	gyv
gyw	gyw
gyx	gyx
gyy	gyy
gyz	gyz
gza	gza
gzb	gzb
gzc	gzc
gzd	gzd
gze	gze
gzf	gzf
gzg	gzg
gzh	gzh
gzi	gzi
gzj	gzj
gzk	gzk
gzl	gzl
gzm	gzm
gzn	gzn
gzo	gzo
gzp	gzp
gzq	gzq
gzr	gzr
gzs	gzs
gzt	gzt
gzu	gzu
gzv	gzv
gzw	gzw
gzx	gzx
gzy	gzy
gzz	gzz
haa	haa
hab	hab
hac	hac
had	had
hae	hae
haf	haf
hag	hag
hah	hah
hai	hai
haj	haj
hak	hak
hal	hal
ham	ham
han	han
hao	hao
hap	hap
haq	haq
har	har
has	has
hat	hat
hau	hau
hav	hav
haw	haw
hax	hax
hay	hay
haz	haz
hba	hba
hbb	hbb
hbc	hbc
hbd	hbd
hbe	hbe
hbf	hbf
hbg	hbg
hbh	hbh
hbi	hbi
hbj	hbj
hbk	hbk
hbl	hbl
hbm	hbm
hbn	hbn
hbo	hbo
hbp	hbp
hbq	hbq
hbr	hbr
hbs	hbs
hbt	hbt
hbu	hbu
hbv	hbv
hbw	hbw
hbx	hbx
hby	hby
hbz	hbz
hca	hca
hcb	hcb
hcc	hcc
hcd	hcd
hce	hce
hcf	hcf
hcg	hcg
hch	hch
hci	hci
hcj	hcj
hck	hck
hcl	hcl
hcm	hcm
hcn	hcn
hco	hco
hcp	hcp
hcq	hcq
hcr	hcr
hcs	hcs
hct	hct
hcu	hcu
hcv	hcv
hcw	hcw
hcx	hcx
hcy	hcy
hcz	hcz
hda	hda
hdb	hdb
hdc	hdc
hdd	hdd
hde	hde
hdf	hdf
hdg	hdg
hdh	hdh
hdi	hdi
hdj	hdj
hdk	hdk
hdl	hdl
hdm	hdm
hdn	hdn
hdo	hdo
hdp	hdp
hdq	hdq
hdr	hdr
hds	hds
hdt	hdt
hdu	hdu
hdv	hdv
hdw	hdw
hdx	hdx
hdy	hdy
hdz	hdz
hea	hea
heb	heb
hec	hec
hed	hed
hee	hee
hef	hef
heg	heg
heh	heh
hei	hei
hej	hej
hek	hek
hel	hel
hem	hem
hen	hen
heo	heo
hep	hep
heq	heq
her	her
hes	hes
het	het
heu	heu
hev	hev
hew	hew
hex	hex
hey	hey
hez	hez
hfa	hfa
hfb	hfb
hfc	hfc
hfd	hfd
hfe	hfe
hff	hff
hfg	hfg
hfh	hfh
hfi	hfi
hfj	hfj
hfk	hfk
hfl	hfl
hfm	hfm
hfn	hfn
hfo	hfo
hfp	hfp
hfq	hfq
hfr	hfr
hfs	hfs
hft	hft
hfu	hfu
hfv	hfv
hfw	hfw
hfx	hfx
hfy	hfy
hfz	hfz
hga	hga
hgb	hgb
hgc	hgc
hgd	hgd
hge	hge
hgf	hgf
hgg	hgg
hgh	hgh
hgi	hgi
hgj	hgj
hgk	hgk
hgl	hgl
hgm	hgm
hgn	hgn
hgo	hgo
hgp	hgp
hgq	hgq
hgr	hgr
hgs	hgs
hgt	hgt
hgu	hgu
hgv	hgv
hgw	hgw
hgx	hgx
hgy	hgy
hgz	hgz
hha	hha
hhb	hhb
hhc	hhc
hhd	hhd
hhe	hhe
hhf	hhf
hhg	hhg
hhh	hhh
hhi	hhi
hhj	hhj
hhk	hhk
hhl	hhl
hhm	hhm
hhn	hhn
hho	hho
hhp	hhp
hhq	hhq
hhr	hhr
hhs	hhs
hht	hht
hhu	hhu
hhv	hhv
hhw	hhw
hhx	hhx
hhy	hhy
hhz	hhz
hia	hia
hib	hib
hic	hic
hid	hid
hie	hie
hif	hif
hig	hig
hih	hih
hii	hii
hij	hij
hik	hik
hil	hil
him	him
hin	hin
hio	hio
hip	hip
hiq	hiq
hir	hir
his	his
hit	hit
hiu	hiu
hiv	hiv
hiw	hiw
hix	hix
hiy	hiy
hiz	hiz
hja	hja
hjb	hjb
hjc	hjc
hjd	hjd
hje	hje
hjf	hjf
hjg	hjg
hjh	hjh
hji	hji
hjj	hjj
hjk	hjk
hjl	hjl
hjm	hjm
hjn	hjn
hjo	hjo
hjp	hjp
hjq	hjq
hjr	hjr
hjs	hjs
hjt	hjt
hju	hju
hjv	hjv
hjw	hjw
hjx	hjx
hjy	hjy
hjz	hjz
hka	hka
hkb	hkb
hkc	hkc
hkd	hkd
hke	hke
hkf	hkf
hkg	hkg
hkh	hkh
hki	hki
hkj	hkj
hkk	hkk
hkl	hkl
hkm	hkm
hkn	hkn
hko	hko
hkp	hkp
hkq	hkq
hkr	hkr
hks	hks
hkt	hkt
hku	hku
hkv	hkv
hkw	hkw
hkx	hkx
hky	hky
hkz	hkz
hla	hla
hlb	hlb
hlc	hlc
hld	hld
hle	hle
hlf	hlf
hlg	hlg
hlh	hlh
hli	hli
hlj	hlj
hlk	hlk
hll	hll
hlm	hlm
hln	hln
hlo	hlo
hlp	hlp
hlq	hlq
hlr	hlr
hls	hls
hlt	hlt
hlu	hlu
hlv	hlv
hlw	hlw
hlx	hlx
hly	hly
hlz	hlz
hma	hma
hmb	hmb
hmc	hmc
hmd	hmd
hme	hme
hmf	hmf
hmg	hmg
hmh	hmh
hmi	hmi
hmj	hmj
hmk	hmk
hml	hml
hmm	hmm
hmn	hmn
hmo	hmo
hmp	hmp
hmq	hmq
hmr	hmr
hms	hms
hmt	hmt
hmu	hmu
hmv	hmv
hmw	hmw
hmx	hmx
hmy	hmy
hmz	hmz
hna	hna
hnb	hnb
hnc	hnc
hnd	hnd
hne	hne
hnf	hnf
hng	hng
hnh	hnh
hni	hni
hnj	hnj
hnk	hnk
hnl	hnl
hnm	hnm
hnn	hnn
hno	hno
hnp	hnp
hnq	hnq
hnr	hnr
hns	hns
hnt	hnt
hnu	hnu
hnv	hnv
hnw	hnw
hnx	hnx
hny	hny
hnz	hnz
hoa	hoa
hob	hob
hoc	hoc
hod	hod
hoe	hoe
hof	hof
hog	hog
hoh	hoh
hoi	hoi
hoj	hoj
hok	hok
hol	hol
hom	hom
hon	hon
hoo	hoo
hop	hop
hoq	hoq
hor	hor
hos	hos
hot	hot
hou	hou
hov	hov
how	how
hox	hox
hoy	hoy
hoz	hoz
hpa	hpa
hpb	hpb
hpc	hpc
hpd	hpd
hpe	hpe
hpf	hpf
hpg	hpg
hph	hph
hpi	hpi
hpj	hpj
hpk	hpk
hpl	hpl
hpm	hpm
hpn	hpn
hpo	hpo
hpp	hpp
hpq	hpq
hpr	hpr
hps	hps
hpt	hpt
hpu	hpu
hpv	hpv
hpw	hpw
hpx	hpx
hpy	hpy
hpz	hpz
hqa	hqa
hqb	hqb
hqc	hqc
hqd	hqd
hqe	hqe
hqf	hqf
hqg	hqg
hqh	hqh
hqi	hqi
hqj	hqj
hqk	hqk
hql	hql
hqm	hqm
hqn	hqn
hqo	hqo
hqp	hqp
hqq	hqq
hqr	hqr
hqs	hqs
hqt	hqt
hqu	hqu
hqv	hqv
hqw	hqw
hqx	hqx
hqy	hqy
hqz	hqz
hra	hra
hrb	hrb
hrc	hrc
hrd	hrd
hre	hre
hrf	hrf
hrg	hrg
hrh	hrh
hri	hri
hrj	hrj
hrk	hrk
hrl	hrl
hrm	hrm
hrn	hrn
hro	hro
hrp	hrp
hrq	hrq
hrr	hrr
hrs	hrs
hrt	hrt
hru	hru
hrv	hrv
hrw	hrw
hrx	hrx
hry	hry
hrz	hrz
hsa	hsa
hsb	hsb
hsc	hsc
hsd	hsd
hse	hse
hsf	hsf
hsg	hsg
hsh	hsh
hsi	hsi
hsj	hsj
hsk	hsk
hsl	hsl
hsm	hsm
hsn	hsn
hso	hso
hsp	hsp
hsq	hsq
hsr	hsr
hss	hss
hst	hst
hsu	hsu
hsv	hsv
hsw	hsw
hsx	hsx
hsy	hsy
hsz	hsz
hta	hta
htb	htb
htc	htc
htd	htd
hte	hte
htf	htf
htg	htg
hth	hth
hti	hti
htj	htj
htk	htk
htl	htl
htm	htm
htn	htn
hto	hto
htp	htp
htq	htq
htr	htr
hts	hts
htt	htt
htu	htu
htv	htv
htw	htw
htx	htx
hty	hty
htz	htz
hua	hua
hub	hub
huc	huc
hud	hud
hue	hue
huf	huf
hug	hug
huh	huh
hui	hui
huj	huj
huk	huk
hul	hul
hum	hum
hun	hun
huo	huo
hup	hup
huq	huq
hur	hur
hus	hus
hut	hut
huu	huu
huv	huv
huw	huw
hux	hux
huy	huy
huz	huz
hva	hva
hvb	hvb
hvc	hvc
hvd	hvd
hve	hve
hvf	hvf
hvg	hvg
hvh	hvh
hvi	hvi
hvj	hvj
hvk	hvk
hvl	hvl
hvm	hvm
hvn	hvn
hvo	hvo
hvp	hvp
hvq	hvq
hvr	hvr
hvs	hvs
hvt	hvt
hvu	hvu
hvv	hvv
hvw	hvw
hvx	hvx
hvy	hvy
hvz	hvz
hwa	hwa
hwb	hwb
hwc	hwc
hwd	hwd
hwe	hwe
hwf	hwf
hwg	hwg
hwh	hwh
hwi	hwi
hwj	hwj
hwk	hwk
hwl	hwl
hwm	hwm
hwn	hwn
hwo	hwo
hwp	hwp
hwq	hwq
hwr	hwr
hws	hws
hwt	hwt
hwu	hwu
hwv	hwv
hww	hww
hwx	hwx
hwy	hwy
hwz	hwz
hxa	hxa
hxb	hxb
hxc	hxc
hxd	hxd
hxe	hxe
hxf	hxf
hxg	hxg
hxh	hxh
hxi	hxi
hxj	hxj
hxk	hxk
hxl	hxl
hxm	hxm
hxn	hxn
hxo	hxo
hxp	hxp
hxq	hxq
hxr	hxr
hxs	hxs
hxt	hxt
hxu	hxu
hxv	hxv
hxw	hxw
hxx	hxx
hxy	hxy
hxz	hxz
hya	hya
hyb	hyb
hyc	hyc
hyd	hyd
hye	hye
hyf	hyf
hyg	hyg
hyh	hyh
hyi	hyi
hyj	hyj
hyk	hyk
hyl	hyl
hym	hym
hyn	hyn
hyo	hyo
hyp	hyp
hyq	hyq
hyr	hyr
hys	hys
hyt	hyt
hyu	hyu
hyv	hyv
hyw	hyw
hyx	hyx
hyy	hyy
hyz	hyz
hza	hza
hzb	hzb
hzc	hzc
hzd	hzd
hze	hze
hzf	hzf
hzg	hzg
hzh	hzh
hzi	hzi
hzj	hzj
hzk	hzk
hzl	hzl
hzm	hzm
hzn	hzn
hzo	hzo
hzp	hzp
hzq	hzq
hzr	hzr
hzs	hzs
hzt	hzt
hzu	hzu
hzv	hzv
hzw	hzw
hzx	hzx
hzy	hzy
hzz	hzz
iaa	iaa
iab	iab
iac	iac
iad	iad
iae	iae
iaf	iaf
iag	iag
iah	iah
iai	iai
iaj	iaj
iak	iak
ial	ial
iam	iam
ian	ian
iao	iao
iap	iap
iaq	iaq
iar	iar
ias	ias
iat	iat
iau	iau
iav	iav
iaw	iaw
iax	iax
iay	iay
iaz	iaz
iba	iba
ibb	ibb
ibc	ibc
ibd	ibd
ibe	ibe
ibf	ibf
ibg	ibg
ibh	ibh
ibi	ibi
ibj	ibj
ibk	ibk
ibl	ibl
ibm	ibm
ibn	ibn
ibo	ibo
ibp	ibp
ibq	ibq
ibr	ibr
ibs	ibs
ibt	ibt
ibu	ibu
ibv	ibv
ibw	ibw
ibx	ibx
iby	iby
ibz	ibz
ica	ica
icb	icb
icc	icc
icd	icd
ice	ice
icf	icf
icg	icg
ich	ich
ici	ici
icj	icj
ick	ick
icl	icl
icm	icm
icn	icn
ico	ico
icp	icp
icq	icq
icr	icr
ics	ics
ict	ict
icu	icu
icv	icv
icw	icw
icx	icx
icy	icy
icz	icz
ida	ida
idb	idb
idc	idc
idd	idd
ide	ide
idf	idf
idg	idg
idh	idh
idi	idi
idj	idj
idk	idk
idl	idl
idm	idm
idn	idn
ido	ido
idp	idp
idq	idq
idr	idr
ids	ids
idt	idt
idu	idu
idv	idv
idw	idw
idx	idx
idy	idy
idz	idz
iea	iea
ieb	ieb
iec	iec
ied	ied
iee	iee
ief	ief
ieg	ieg
ieh	ieh
iei	iei
iej	iej
iek	iek
iel	iel
iem	iem
ien	ien
ieo	ieo
iep	iep
ieq	ieq
ier	ier
ies	ies
iet	iet
ieu	ieu
iev	iev
iew	iew
iex	iex
iey	iey
iez	iez
ifa	ifa
ifb	ifb
ifc	ifc
ifd	ifd
ife	ife
iff	iff
ifg	ifg
ifh	ifh
ifi	ifi
ifj	ifj
ifk	ifk
ifl	ifl
ifm	ifm
ifn	ifn
ifo	ifo
ifp	ifp
ifq	ifq
ifr	ifr
ifs	ifs
ift	ift
ifu	ifu
ifv	ifv
ifw	ifw
ifx	ifx
ify	ify
ifz	ifz
iga	iga
igb	igb
igc	igc
igd	igd
ige	ige
igf	igf
igg	igg
igh	igh
igi	igi
igj	igj
igk	igk
igl	igl
igm	igm
ign	ign
igo	igo
igp	igp
igq	igq
igr	igr
igs	igs
igt	igt
igu	igu
igv	igv
igw	igw
igx	igx
igy	igy
igz	igz
iha	iha
ihb	ihb
ihc	ihc
ihd	ihd
ihe	ihe
ihf	ihf
ihg	ihg
ihh	ihh
ihi	ihi
ihj	ihj
ihk	ihk
ihl	ihl
ihm	ihm
ihn	ihn
iho	iho
ihp	ihp
ihq	ihq
ihr	ihr
ihs	ihs
iht	iht
ihu	ihu
ihv	ihv
ihw	ihw
ihx	ihx
ihy	ihy
ihz	ihz
iia	iia
iib	iib
iic	iic
iid	iid
iie	iie
iif	iif
iig	iig
iih	iih
iii	iii
iij	iij
iik	iik
iil	iil
iim	iim
iin	iin
iio	iio
iip	iip
iiq	iiq
iir	iir
iis	iis
iit	iit
iiu	iiu
iiv	iiv
iiw	iiw
iix	iix
iiy	iiy
iiz	iiz
ija	ija
ijb	ijb
ijc	ijc
ijd	ijd
ije	ije
ijf	ijf
ijg	ijg
ijh	ijh
iji	iji
ijj	ijj
ijk	ijk
ijl	ijl
ijm	ijm
ijn	ijn
ijo	ijo
ijp	ijp
ijq	ijq
ijr	ijr
ijs	ijs
ijt	ijt
iju	iju
ijv	ijv
ijw	ijw
ijx	ijx
ijy	ijy
ijz	ijz
ika	ika
ikb	ikb
ikc	ikc
ikd	ikd
ike	ike
ikf	ikf
ikg	ikg
ikh	ikh
iki	iki
ikj	ikj
ikk	ikk
ikl	ikl
ikm	ikm
ikn	ikn
iko	iko
ikp	ikp
ikq	ikq
ikr	ikr
iks	iks
ikt	ikt
iku	iku
ikv	ikv
ikw	ikw
ikx	ikx
iky	iky
ikz	ikz
ila	ila
ilb	ilb
ilc	ilc
ild	ild
ile	ile
ilf	ilf
ilg	ilg
ilh	ilh
ili	ili
ilj	ilj
ilk	ilk
ill	ill
ilm	ilm
iln	iln
ilo	ilo
ilp	ilp
ilq	ilq
ilr	ilr
ils	ils
ilt	ilt
ilu	ilu
ilv	ilv
ilw	ilw
ilx	ilx
ily	ily
ilz	ilz
ima	ima
imb	imb
imc	imc
imd	imd
ime	ime
imf	imf
img	img
imh	imh
imi	imi
imj	imj
imk	imk
iml	iml
imm	imm
imn	imn
imo	imo
imp	imp
imq	imq
imr	imr
ims	ims
imt	imt
imu	imu
imv	imv
imw	imw
imx	imx
imy	imy
imz	imz
ina	ina
inb	inb
inc	inc
ind	ind
ine	ine
inf	inf
ing	ing
inh	inh
ini	ini
inj	inj
ink	ink
inl	inl
inm	inm
inn	inn
ino	ino
inp	inp
inq	inq
inr	inr
ins	ins
int	int
inu	inu
inv	inv
inw	inw
inx	inx
iny	iny
inz	inz
ioa	ioa
iob	iob
ioc	ioc
iod	iod
ioe	ioe
iof	iof
iog	iog
ioh	ioh
ioi	ioi
ioj	ioj
iok	iok
iol	iol
iom	iom
ion	ion
ioo	ioo
iop	iop
ioq	ioq
ior	ior
ios	ios
iot	iot
iou	iou
iov	iov
iow	iow
iox	iox
ioy	ioy
ioz	ioz
ipa	ipa
ipb	ipb
ipc	ipc
ipd	ipd
ipe	ipe
ipf	ipf
ipg	ipg
iph	iph
ipi	ipi
ipj	ipj
ipk	ipk
ipl	ipl
ipm	ipm
ipn	ipn
ipo	ipo
ipp	ipp
ipq	ipq
ipr	ipr
ips	ips
ipt	ipt
ipu	ipu
ipv	ipv
ipw	ipw
ipx	ipx
ipy	ipy
ipz	ipz
iqa	iqa
iqb	iqb
iqc	iqc
iqd	iqd
iqe	iqe
iqf	iqf
iqg	iqg
iqh	iqh
iqi	iqi
iqj	iqj
iqk	iqk
iql	iql
iqm	iqm
iqn	iqn
iqo	iqo
iqp	iqp
iqq	iqq
iqr	iqr
iqs	iqs
iqt	iqt
iqu	iqu
iqv	iqv
iqw	iqw
iqx	iqx
iqy	iqy
iqz	iqz
ira	ira
irb	irb
irc	irc
ird	ird
ire	ire
irf	irf
irg	irg
irh	irh
iri	iri
irj	irj
irk	irk
irl	irl
irm	irm
irn	irn
iro	iro
irp	irp
irq	irq
irr	irr
irs	irs
irt	irt
iru	iru
irv	irv
irw	irw
irx	irx
iry	iry
irz	irz
isa	isa
isb	isb
isc	isc
isd	isd
ise	ise
isf	isf
isg	isg
ish	ish
isi	isi
isj	isj
isk	isk
isl	isl
ism	ism
isn	isn
iso	iso
isp	isp
isq	isq
isr	isr
iss	iss
ist	ist
isu	isu
isv	isv
isw	isw
isx	isx
isy	isy
isz	isz
ita	ita
itb	itb
itc	itc
itd	itd
ite	ite
itf	itf
itg	itg
ith	ith
iti	iti
itj	itj
itk	itk
itl	itl
itm	itm
itn	itn
ito	ito
itp	itp
itq	itq
itr	itr
its	its
itt	itt
itu	itu
itv	itv
itw	itw
itx	itx
ity	ity
itz	itz
iua	iua
iub	iub
iuc	iuc
iud	iud
iue	iue
iuf	iuf
iug	iug
iuh	iuh
iui	iui
iuj	iuj
iuk	iuk
iul	iul
ium	ium
iun	iun
iuo	iuo
iup	iup
iuq	iuq
iur	iur
ius	ius
iut	iut
iuu	iuu
iuv	iuv
iuw	iuw
iux	iux
iuy	iuy
iuz	iuz
iva	iva
ivb	ivb
ivc	ivc
ivd	ivd
ive	ive
ivf	ivf
ivg	ivg
ivh	ivh
ivi	ivi
ivj	ivj
ivk	ivk
ivl	ivl
ivm	ivm
ivn	ivn
ivo	ivo
ivp	ivp
ivq	ivq
ivr	ivr
ivs	ivs
ivt	ivt
ivu	ivu
ivv	ivv
ivw	ivw
ivx	ivx
ivy	ivy
ivz	ivz
iwa	iwa
iwb	iwb
iwc	iwc
iwd	iwd
iwe	iwe
iwf	iwf
iwg	iwg
iwh	iwh
iwi	iwi
iwj	iwj
iwk	iwk
iwl	iwl
iwm	iwm
iwn	iwn
iwo	iwo
iwp	iwp
iwq	iwq
iwr	iwr
iws	iws
iwt	iwt
iwu	iwu
iwv	iwv
iww	iww
iwx	iwx
iwy	iwy
iwz	iwz
ixa	ixa
ixb	ixb
ixc	ixc
ixd	ixd
ixe	ixe
ixf	ixf
ixg	ixg
ixh	ixh
ixi	ixi
ixj	ixj
ixk	ixk
ixl	ixl
ixm	ixm
ixn	ixn
ixo	ixo
ixp	ixp
ixq	ixq
ixr	ixr
ixs	ixs
ixt	ixt
ixu	ixu
ixv	ixv
ixw	ixw
ixx	ixx
ixy	ixy
ixz	ixz
iya	iya
iyb	iyb
iyc	iyc
iyd	iyd
iye	iye
iyf	iyf
iyg	iyg
iyh	iyh
iyi	iyi
iyj	iyj
iyk	iyk
iyl	iyl
iym	iym
iyn	iyn
iyo	iyo
iyp	iyp
iyq	iyq
iyr	iyr
iys	iys
iyt	iyt
iyu	iyu
iyv	iyv
iyw	iyw
iyx	iyx
iyy	iyy
iyz	iyz
iza	iza
izb	izb
izc	izc
izd	izd
ize	ize
izf	izf
izg	izg
izh	izh
izi	izi
izj	izj
izk	izk
izl	izl
izm	izm
izn	izn
izo	izo
izp	izp
izq	izq
izr	izr
izs	izs
izt	izt
izu	izu
izv	izv
izw	izw
izx	izx
izy	izy
izz	izz
jaa	jaa
jab	jab
jac	jac
jad	jad
jae	jae
jaf	jaf
jag	jag
jah	jah
jai	jai
jaj	jaj
jak	jak
jal	jal
jam	jam
jan	jan
jao	jao
jap	jap
jaq	jaq
jar	jar
jas	jas
jat	jat
jau	jau
jav	jav
jaw	jaw
jax	jax
jay	jay
jaz	jaz
jba	jba
jbb	jbb
jbc	jbc
jbd	jbd
jbe	jbe
jbf	jbf
jbg	jbg
jbh	jbh
jbi	jbi
jbj	jbj
jbk	jbk
jbl	jbl
jbm	jbm
jbn	jbn
jbo	jbo
jbp	jbp
jbq	jbq
jbr	jbr
jbs	jbs
jbt	jbt
jbu	jbu
jbv	jbv
jbw	jbw
jbx	jbx
jby	jby
jbz	jbz
jca	jca
jcb	jcb
jcc	jcc
jcd	jcd
jce	jce
jcf	jcf
jcg	jcg
jch	jch
jci	jci
jcj	jcj
jck	jck
jcl	jcl
jcm	jcm
jcn	jcn
jco	jco
jcp	jcp
jcq	jcq
jcr	jcr
jcs	jcs
jct	jct
jcu	jcu
jcv	jcv
jcw	jcw
jcx	jcx
jcy	jcy
jcz	jcz
jda	jda
jdb	jdb
jdc	jdc
jdd	jdd
jde	jde
jdf	jdf
jdg	jdg
jdh	jdh
jdi	jdi
jdj	jdj
jdk	jdk
jdl	jdl
jdm	jdm
jdn	jdn
jdo	jdo
jdp	jdp
jdq	jdq
jdr	jdr
jds	jds
jdt	jdt
jdu	jdu
jdv	jdv
jdw	jdw
jdx	jdx
jdy	jdy
jdz	jdz
jea	jea
jeb	jeb
jec	jec
jed	jed
jee	jee
jef	jef
jeg	jeg
jeh	jeh
jei	jei
jej	jej
jek	jek
jel	jel
jem	jem
jen	jen
jeo	jeo
jep	jep
jeq	jeq
jer	jer
jes	jes
jet	jet
jeu	jeu
jev	jev
jew	jew
jex	jex
jey	jey
jez	jez
jfa	jfa
jfb	jfb
jfc	jfc
jfd	jfd
jfe	jfe
jff	jff
jfg	jfg
jfh	jfh
jfi	jfi
jfj	jfj
jfk	jfk
jfl	jfl
jfm	jfm
jfn	jfn
jfo	jfo
jfp	jfp
jfq	jfq
jfr	jfr
jfs	jfs
jft	jft
jfu	jfu
jfv	jfv
jfw	jfw
jfx	jfx
jfy	jfy
jfz	jfz
jga	jga
jgb	jgb
jgc	jgc
jgd	jgd
jge	jge
jgf	jgf
jgg	jgg
jgh	jgh
jgi	jgi
jgj	jgj
jgk	jgk
jgl	jgl
jgm	jgm
jgn	jgn
jgo	jgo
jgp	jgp
jgq	jgq
jgr	jgr
jgs	jgs
jgt	jgt
jgu	jgu
jgv	jgv
jgw	jgw
jgx	jgx
jgy	jgy
jgz	jgz
jha	jha
jhb	jhb
jhc	jhc
jhd	jhd
jhe	jhe
jhf	jhf
jhg	jhg
jhh	jhh
jhi	jhi
jhj	jhj
jhk	jhk
jhl	jhl
jhm	jhm
jhn	jhn
jho	jho
jhp	jhp
jhq	jhq
jhr	jhr
jhs	jhs
jht	jht
jhu	jhu
jhv	jhv
jhw	jhw
jhx	jhx
jhy	jhy
jhz	jhz
jia	jia
jib	jib
jic	jic
jid	jid
jie	jie
jif	jif
jig	jig
jih	jih
jii	jii
jij	jij
jik	jik
jil	jil
jim	jim
jin	jin
jio	jio
jip	jip
jiq	jiq
jir	jir
jis	jis
jit	jit
jiu	jiu
jiv	jiv
jiw	jiw
jix	jix
jiy	jiy
jiz	jiz
jja	jja
jjb	jjb
jjc	jjc
jjd	jjd
jje	jje
jjf	jjf
jjg	jjg
jjh	jjh
jji	jji
jjj	jjj
jjk	jjk
jjl	jjl
jjm	jjm
jjn	jjn
jjo	jjo
jjp	jjp
jjq	jjq
jjr	jjr
jjs	jjs
jjt	jjt
jju	jju
jjv	jjv
jjw	jjw
jjx	jjx
jjy	jjy
jjz	jjz
jka	jka
jkb	jkb
jkc	jkc
jkd	jkd
jke	jke
jkf	jkf
jkg	jkg
jkh	jkh
jki	jki
jkj	jkj
jkk	jkk
jkl	jkl
jkm	jkm
jkn	jkn
jko	jko
jkp	jkp
jkq	jkq
jkr	jkr
jks	jks
jkt	jkt
jku	jku
jkv	jkv
jkw	jkw
jkx	jkx
jky	jky
jkz	jkz
jla	jla
jlb	jlb
jlc	jlc
jld	jld
jle	jle
jlf	jlf
jlg	jlg
jlh	jlh
jli	jli
jlj	jlj
jlk	jlk
jll	jll
jlm	jlm
jln	jln
jlo	jlo
jlp	jlp
jlq	jlq
jlr	jlr
jls	jls
jlt	jlt
jlu	jlu
jlv	jlv
jlw	jlw
jlx	jlx
jly	jly
jlz	jlz
jma	jma
jmb	jmb
jmc	jmc
jmd	jmd
jme	jme
jmf	jmf
jmg	jmg
jmh	jmh
jmi	jmi
jmj	jmj
jmk	jmk
jml	jml
jmm	jmm
jmn	jmn
jmo	jmo
jmp	jmp
jmq	jmq
jmr	jmr
jms	jms
jmt	jmt
jmu	jmu
jmv	jmv
jmw	jmw
jmx	jmx
jmy	jmy
jmz	jmz
jna	jna
jnb	jnb
jnc	jnc
jnd	jnd
jne	jne
jnf	jnf
jng	jng
jnh	jnh
jni	jni
jnj	jnj
jnk	jnk
jnl	jnl
jnm	jnm
jnn	jnn
jno	jno
jnp	jnp
jnq	jnq
jnr	jnr
jns	jns
jnt	jnt
jnu	jnu
jnv	jnv
jnw	jnw
jnx	jnx
jny	jny
jnz	jnz
joa	joa
job	job
joc	joc
jod	jod
joe	joe
jof	jof
jog	jog
joh	joh
joi	joi
joj	joj
jok	jok
jol	jol
jom	jom
jon	jon
joo	joo
jop	jop
joq	joq
jor	jor
jos	jos
jot	jot
jou	jou
jov	jov
jow	jow
jox	jox
joy	joy
joz	joz
jpa	jpa
jpb	jpb
jpc	jpc
jpd	jpd
jpe	jpe
jpf	jpf
jpg	jpg
jph	jph
jpi	jpi
jpj	jpj
jpk	jpk
jpl	jpl
jpm	jpm
jpn	jpn
jpo	jpo
jpp	jpp
jpq	jpq
jpr	jpr
jps	jps
jpt	jpt
jpu	jpu
jpv	jpv
jpw	jpw
jpx	jpx
jpy	jpy
jpz	jpz
jqa	jqa
jqb	jqb
jqc	jqc
jqd	jqd
jqe	jqe
jqf	jqf
jqg	jqg
jqh	jqh
jqi	jqi
jqj	jqj
jqk	jqk
jql	jql
jqm	jqm
jqn	jqn
jqo	jqo
jqp	jqp
jqq	jqq
jqr	jqr
jqs	jqs
jqt	jqt
jqu	jqu
jqv	jqv
jqw	jqw
jqx	jqx
jqy	jqy
jqz	jqz
jra	jra
jrb	jrb
jrc	jrc
jrd	jrd
jre	jre
jrf	jrf
jrg	jrg
jrh	jrh
jri	jri
jrj	jrj
jrk	jrk
jrl	jrl
jrm	jrm
jrn	jrn
jro	jro
jrp	jrp
jrq	jrq
jrr	jrr
jrs	jrs
jrt	jrt
jru	jru
jrv	jrv
jrw	jrw
jrx	jrx
jry	jry
jrz	jrz
jsa	jsa
jsb	jsb
jsc	jsc
jsd	jsd
jse	jse
jsf	jsf
jsg	jsg
jsh	jsh
jsi	jsi
jsj	jsj
jsk	jsk
jsl	jsl
jsm	jsm
jsn	jsn
jso	jso
jsp	jsp
jsq	jsq
jsr	jsr
jss	jss
jst	jst
jsu	jsu
jsv	jsv
jsw	jsw
jsx	jsx
jsy	jsy
jsz	jsz
jta	jta
jtb	jtb
jtc	jtc
jtd	jtd
jte	jte
jtf	jtf
jtg	jtg
jth	jth
jti	jti
jtj	jtj
jtk	jtk
jtl	jtl
jtm	jtm
jtn	jtn
jto	jto
jtp	jtp
jtq	jtq
jtr	jtr
jts	jts
jtt	jtt
jtu	jtu
jtv	jtv
jtw	jtw
jtx	jtx
jty	jty
jtz	jtz
jua	jua
jub	jub
juc	juc
jud	jud
jue	jue
juf	juf
jug	jug
juh	juh
jui	jui
juj	juj
juk	juk
jul	jul
jum	jum
jun	jun
juo	juo
jup	jup
juq	juq
jur	jur
jus	jus
jut	jut
juu	juu
juv	juv
juw	juw
jux	jux
juy	juy
juz	juz
jva	jva
jvb	jvb
jvc	jvc
jvd	jvd
jve	jve
jvf	jvf
jvg	jvg
jvh	jvh
jvi	jvi
jvj	jvj
jvk	jvk
jvl	jvl
jvm	jvm
jvn	jvn
jvo	jvo
jvp	jvp
jvq	jvq
jvr	jvr
jvs	jvs
jvt	jvt
jvu	jvu
jvv	jvv
jvw	jvw
jvx	jvx
jvy	jvy
jvz	jvz
jwa	jwa
jwb	jwb
jwc	jwc
jwd	jwd
jwe	jwe
jwf	jwf
jwg	jwg
jwh	jwh
jwi	jwi
jwj	jwj
jwk	jwk
jwl	jwl
jwm	jwm
jwn	jwn
jwo	jwo
jwp	jwp
jwq	jwq
jwr	jwr
jws	jws
jwt	jwt
jwu	jwu
jwv	jwv
jww	jww
jwx	jwx
jwy	jwy
jwz	jwz
jxa	jxa
jxb	jxb
jxc	jxc
jxd	jxd
jxe	jxe
jxf	jxf
jxg	jxg
jxh	jxh
jxi	jxi
jxj	jxj
jxk	jxk
jxl	jxl
jxm	jxm
jxn	jxn
jxo	jxo
jxp	jxp
jxq	jxq
jxr	jxr
jxs	jxs
jxt	jxt
jxu	jxu
jxv	jxv
jxw	jxw
jxx	jxx
jxy	jxy
jxz	jxz
jya	jya
jyb	jyb
jyc	jyc
jyd	jyd
jye	jye
jyf	jyf
jyg	jyg
jyh	jyh
jyi	jyi
jyj	jyj
jyk	jyk
jyl	jyl
jym	jym
jyn	jyn
jyo	jyo
jyp	jyp
jyq	jyq
jyr	jyr
jys	jys
jyt	jyt
jyu	jyu
jyv	jyv
jyw	jyw
jyx	jyx
jyy	jyy
jyz	jyz
jza	jza
jzb	jzb
jzc	jzc
jzd	jzd
jze	jze
jzf	jzf
jzg	jzg
jzh	jzh
jzi	jzi
jzj	jzj
jzk	jzk
jzl	jzl
jzm	jzm
jzn	jzn
jzo	jzo
jzp	jzp
jzq	jzq
jzr	jzr
jzs	jzs
jzt	jzt
jzu	jzu
jzv	jzv
jzw	jzw
jzx	jzx
jzy	jzy
jzz	jzz
kaa	kaa
kab	kab
kac	kac
kad	kad
kae	kae
kaf	kaf
kag	kag
kah	kah
kai	kai
kaj	kaj
kak	kak
kal	kal
kam	kam
kan	kan
kao	kao
kap	kap
kaq	kaq
kar	kar
kas	kas
kat	kat
kau	kau
kav	kav
kaw	kaw
kax	kax
kay	kay
kaz	kaz
kba	kba
kbb	kbb
kbc	kbc
kbd	kbd
kbe	kbe
kbf	kbf
kbg	kbg
kbh	kbh
kbi	kbi
kbj	kbj
kbk	kbk
kbl	kbl
kbm	kbm
kbn	kbn
kbo	kbo
kbp	kbp
kbq	kbq
kbr	kbr
kbs	kbs
kbt	kbt
kbu	kbu
kbv	kbv
kbw	kbw
kbx	kbx
kby	kby
kbz	kbz
kca	kca
kcb	kcb
kcc	kcc
kcd	kcd
kce	kce
kcf	kcf
kcg	kcg
kch	kch
kci	kci
kcj	kcj
kck	kck
kcl	kcl
kcm	kcm
kcn	kcn
kco	kco
kcp	kcp
kcq	kcq
kcr	kcr
kcs	kcs
kct	kct
kcu	kcu
kcv	kcv
kcw	kcw
kcx	kcx
kcy	kcy
kcz	kcz
kda	kda
kdb	kdb
kdc	kdc
kdd	kdd
kde	kde
kdf	kdf
kdg	kdg
kdh	kdh
kdi	kdi
kdj	kdj
kdk	kdk
kdl	kdl
kdm	kdm
kdn	kdn
kdo	kdo
kdp	kdp
kdq	kdq
kdr	kdr
kds	kds
kdt	kdt
kdu	kdu
kdv	kdv
kdw	kdw
kdx	kdx
kdy	kdy
kdz	kdz
kea	kea
keb	keb
kec	kec
ked	ked
kee	kee
kef	kef
keg	keg
keh	keh
kei	kei
kej	kej
kek	kek
kel	kel
kem	kem
ken	ken
keo	keo
kep	kep
keq	keq
ker	ker
kes	kes
ket	ket
keu	keu
kev	kev
kew	kew
kex	kex
key	key
kez	kez
kfa	kfa
kfb	kfb
kfc	kfc
kfd	kfd
kfe	kfe
kff	kff
kfg	kfg
kfh	kfh
kfi	kfi
kfj	kfj
kfk	kfk
kfl	kfl
kfm	kfm
kfn	kfn
kfo	kfo
kfp	kfp
kfq	kfq
kfr	kfr
kfs	kfs
kft	kft
kfu	kfu
kfv	kfv
kfw	kfw
kfx	kfx
kfy	kfy
kfz	kfz
kga	kga
kgb	kgb
kgc	kgc
kgd	kgd
kge	kge
kgf	kgf
kgg	kgg
kgh	kgh
kgi	kgi
kgj	kgj
kgk	kgk
kgl	kgl
kgm	kgm
kgn	kgn
kgo	kgo
kgp	kgp
kgq	kgq
kgr	kgr
kgs	kgs
kgt	kgt
kgu	kgu
kgv	kgv
kgw	kgw
kgx	kgx
kgy	kgy
kgz	kgz
kha	kha
khb	khb
khc	khc
khd	khd
khe	khe
khf	khf
khg	khg
khh	khh
khi	khi
khj	khj
khk	khk
khl	khl
khm	khm
khn	khn
kho	kho
khp	khp
khq	khq
khr	khr
khs	khs
kht	kht
khu	khu
khv	khv
khw	khw
khx	khx
khy	khy
khz	khz
kia	kia
kib	kib
kic	kic
kid	kid
kie	kie
kif	kif
kig	kig
kih	kih
kii	kii
kij	kij
kik	kik
kil	kil
kim	kim
kin	kin
kio	kio
kip	kip
kiq	kiq
kir	kir
kis	kis
kit	kit
kiu	kiu
kiv	kiv
kiw	kiw
kix	kix
kiy	kiy
kiz	kiz
kja	kja
kjb	kjb
kjc	kjc
kjd	kjd
kje	kje
kjf	kjf
kjg	kjg
kjh	kjh
kji	kji
kjj	kjj
kjk	kjk
kjl	kjl
kjm	kjm
kjn	kjn
kjo	kjo
kjp	kjp
kjq	kjq
kjr	kjr
kjs	kjs
kjt	kjt
kju	kju
kjv	kjv
kjw	kjw
kjx	kjx
kjy	kjy
kjz	kjz
kka	kka
kkb	kkb
kkc	kkc
kkd	kkd
kke	kke
kkf	kkf
kkg	kkg
kkh	kkh
kki	kki
kkj	kkj
kkk	kkk
kkl	kkl
kkm	kkm
kkn	kkn
kko	kko
kkp	kkp
kkq	kkq
kkr	kkr
kks	kks
kkt	kkt
kku	kku
kkv	kkv
kkw	kkw
kkx	kkx
kky	kky
kkz	kkz
kla	kla
klb	klb
klc	klc
kld	kld
kle	kle
klf	klf
klg	klg
klh	klh
kli	kli
klj	klj
klk	klk
kll	kll
klm	klm
kln	kln
klo	klo
klp	klp
klq	klq
klr	klr
kls	kls
klt	klt
klu	klu
klv	klv
klw	klw
klx	klx
kly	kly
klz	klz
kma	kma
kmb	kmb
kmc	kmc
kmd	kmd
kme	kme
kmf	kmf
kmg	kmg
kmh	kmh
kmi	kmi
kmj	kmj
kmk	kmk
kml	kml
kmm	kmm
kmn	kmn
kmo	kmo
kmp	kmp
kmq	kmq
kmr	kmr
kms	kms
kmt	kmt
kmu	kmu
kmv	kmv
kmw	kmw
kmx	kmx
kmy	kmy
kmz	kmz
kna	kna
knb	knb
knc	knc
knd	knd
kne	kne
knf	knf
kng	kng
knh	knh
kni	kni
knj	knj
knk	knk
knl	knl
knm	knm
knn	knn
kno	kno
knp	knp
knq	knq
knr	knr
kns	kns
knt	knt
knu	knu
knv	knv
knw	knw
knx	knx
kny	kny
knz	knz
koa	koa
kob	kob
koc	koc
kod	kod
koe	koe
kof	kof
kog	kog
koh	koh
koi	koi
koj	koj
kok	kok
kol	kol
kom	kom
kon	kon
koo	koo
kop	kop
koq	koq
kor	kor
kos	kos
kot	kot
kou	kou
kov	kov
kow	kow
kox	kox
koy	koy
koz	koz
kpa	kpa
kpb	kpb
kpc	kpc
kpd	kpd
kpe	kpe
kpf	kpf
kpg	kpg
kph	kph
kpi	kpi
kpj	kpj
kpk	kpk
kpl	kpl
kpm	kpm
kpn	kpn
kpo	kpo
kpp	kpp
kpq	kpq
kpr	kpr
kps	kps
kpt	kpt
kpu	kpu
kpv	kpv
kpw	kpw
kpx	kpx
kpy	kpy
kpz	kpz
kqa	kqa
kqb	kqb
kqc	kqc
kqd	kqd
kqe	kqe
kqf	kqf
kqg	kqg
kqh	kqh
kqi	kqi
kqj	kqj
kqk	kqk
kql	kql
kqm	kqm
kqn	kqn
kqo	kqo
kqp	kqp
kqq	kqq
kqr	kqr
kqs	kqs
kqt	kqt
kqu	kqu
kqv	kqv
kqw	kqw
kqx	kqx
kqy	kqy
kqz	kqz
kra	kra
krb	krb
krc	krc
krd	krd
kre	kre
krf	krf
krg	krg
krh	krh
kri	kri
krj	krj
krk	krk
krl	krl
krm	krm
krn	krn
kro	kro
krp	krp
krq	krq
krr	krr
krs	krs
krt	krt
kru	kru
krv	krv
krw	krw
krx	krx
kry	kry
krz	krz
ksa	ksa
ksb	ksb
ksc	ksc
ksd	ksd
kse	kse
ksf	ksf
ksg	ksg
ksh	ksh
ksi	ksi
ksj	ksj
ksk	ksk
ksl	ksl
ksm	ksm
ksn	ksn
kso	kso
ksp	ksp
ksq	ksq
ksr	ksr
kss	kss
kst	kst
ksu	ksu
ksv	ksv
ksw	ksw
ksx	ksx
ksy	ksy
ksz	ksz
kta	kta
ktb	ktb
ktc	ktc
ktd	ktd
kte	kte
ktf	ktf
ktg	ktg
kth	kth
kti	kti
ktj	ktj
ktk	ktk
ktl	ktl
ktm	ktm
ktn	ktn
kto	kto
ktp	ktp
ktq	ktq
ktr	ktr
kts	kts
ktt	ktt
ktu	ktu
ktv	ktv
ktw	ktw
ktx	ktx
kty	kty
ktz	ktz
kua	kua
kub	kub
kuc	kuc
kud	kud
kue	kue
kuf	kuf
kug	kug
kuh	kuh
kui	kui
kuj	kuj
kuk	kuk
kul	kul
kum	kum
kun	kun
kuo	kuo
kup	kup
kuq	kuq
kur	kur
kus	kus
kut	kut
kuu	kuu
kuv	kuv
kuw	kuw
kux	kux
kuy	kuy
kuz	kuz
kva	kva
kvb	kvb
kvc	kvc
kvd	kvd
kve	kve
kvf	kvf
kvg	kvg
kvh	kvh
kvi	kvi
kvj	kvj
kvk	kvk
kvl	kvl
kvm	kvm
kvn	kvn
kvo	kvo
kvp	kvp
kvq	kvq
kvr	kvr
kvs	kvs
kvt	kvt
kvu	kvu
kvv	kvv
kvw	kvw
kvx	kvx
kvy	kvy
kvz	kvz
kwa	kwa
kwb	kwb
kwc	kwc
kwd	kwd
kwe	kwe
kwf	kwf
kwg	kwg
kwh	kwh
kwi	kwi
kwj	kwj
kwk	kwk
kwl	kwl
kwm	kwm
kwn	kwn
kwo	kwo
kwp	kwp
kwq	kwq
kwr	kwr
kws	kws
kwt	kwt
kwu	kwu
kwv	kwv
kww	kww
kwx	kwx
kwy	kwy
kwz	kwz
kxa	kxa
kxb	kxb
kxc	kxc
kxd	kxd
kxe	kxe
kxf	kxf
kxg	kxg
kxh	kxh
kxi	kxi
kxj	kxj
kxk	kxk
kxl	kxl
kxm	kxm
kxn	kxn
kxo	kxo
kxp	kxp
kxq	kxq
kxr	kxr
kxs	kxs
kxt	kxt
kxu	kxu
kxv	kxv
kxw	kxw
kxx	kxx
kxy	kxy
kxz	kxz
kya	kya
kyb	kyb
kyc	kyc
kyd	kyd
kye	kye
kyf	kyf
kyg	kyg
kyh	kyh
kyi	kyi
kyj	kyj
kyk	kyk
kyl	kyl
kym	kym
kyn	kyn
kyo	kyo
kyp	kyp
kyq	kyq
kyr	kyr
kys	kys
kyt	kyt
kyu	kyu
kyv	kyv
kyw	kyw
kyx	kyx
kyy	kyy
kyz	kyz
kza	kza
kzb	kzb
kzc	kzc
kzd	kzd
kze	kze
kzf	kzf
kzg	kzg
kzh	kzh
kzi	kzi
kzj	kzj
kzk	kzk
kzl	kzl
kzm	kzm
kzn	kzn
kzo	kzo
kzp	kzp
kzq	kzq
kzr	kzr
kzs	kzs
kzt	kzt
kzu	kzu
kzv	kzv
kzw	kzw
kzx	kzx
kzy	kzy
kzz	kzz
laa	laa
lab	lab
lac	lac
lad	lad
lae	lae
laf	laf
lag	lag
lah	lah
lai	lai
laj	laj
lak	lak
lal	lal
lam	lam
lan	lan
lao	lao
lap	lap
laq	laq
lar	lar
las	las
lat	lat
lau	lau
lav	lav
law	law
lax	lax
lay	lay
laz	laz
lba	lba
lbb	lbb
lbc	lbc
lbd	lbd
lbe	lbe
lbf	lbf
lbg	lbg
lbh	lbh
lbi	lbi
lbj	lbj
lbk	lbk
lbl	lbl
lbm	lbm
lbn	lbn
lbo	lbo
lbp	lbp
lbq	lbq
lbr	lbr
lbs	lbs
lbt	lbt
lbu	lbu
lbv	lbv
lbw	lbw
lbx	lbx
lby	lby
lbz	lbz
lca	lca
lcb	lcb
lcc	lcc
lcd	lcd
lce	lce
lcf	lcf
lcg	lcg
lch	lch
lci	lci
lcj	lcj
lck	lck
lcl	lcl
lcm	lcm
lcn	lcn
lco	lco
lcp	lcp
lcq	lcq
lcr	lcr
lcs	lcs
lct	lct
lcu	lcu
lcv	lcv
lcw	lcw
lcx	lcx
lcy	lcy
lcz	lcz
lda	lda
ldb	ldb
ldc	ldc
ldd	ldd
lde	lde
ldf	ldf
ldg	ldg
ldh	ldh
ldi	ldi
ldj	ldj
ldk	ldk
ldl	ldl
ldm	ldm
ldn	ldn
ldo	ldo
ldp	ldp
ldq	ldq
ldr	ldr
lds	lds
ldt	ldt
ldu	ldu
ldv	ldv
ldw	ldw
ldx	ldx
ldy	ldy
ldz	ldz
lea	lea
leb	leb
lec	lec
led	led
lee	lee
lef	lef
leg	leg
leh	leh
lei	lei
lej	lej
lek	lek
lel	lel
lem	lem
len	len
leo	leo
lep	lep
leq	leq
ler	ler
les	les
let	let
leu	leu
lev	lev
lew	lew
lex	lex
ley	ley
lez	lez
lfa	lfa
lfb	lfb
lfc	lfc
lfd	lfd
lfe	lfe
lff	lff
lfg	lfg
lfh	lfh
lfi	lfi
lfj	lfj
lfk	lfk
lfl	lfl
lfm	lfm
lfn	lfn
lfo	lfo
lfp	lfp
lfq	lfq
lfr	lfr
lfs	lfs
lft	lft
lfu	lfu
lfv	lfv
lfw	lfw
lfx	lfx
lfy	lfy
lfz	lfz
lga	lga
lgb	lgb
lgc	lgc
lgd	lgd
lge	lge
lgf	lgf
lgg	lgg
lgh	lgh
lgi	lgi
lgj	lgj
lgk	lgk
lgl	lgl
lgm	lgm
lgn	lgn
lgo	lgo
lgp	lgp
lgq	lgq
lgr	lgr
lgs	lgs
lgt	lgt
lgu	lgu
lgv	lgv
lgw	lgw
lgx	lgx
lgy	lgy
lgz	lgz
lha	lha
lhb	lhb
lhc	lhc
lhd	lhd
lhe	lhe
lhf	lhf
lhg	lhg
lhh	lhh
lhi	lhi
lhj	lhj
lhk	lhk
lhl	lhl
lhm	lhm
lhn	lhn
lho	lho
lhp	lhp
lhq	lhq
lhr	lhr
lhs	lhs
lht	lht
lhu	lhu
lhv	lhv
lhw	lhw
lhx	lhx
lhy	lhy
lhz	lhz
lia	lia
lib	lib
lic	lic
lid	lid
lie	lie
lif	lif
lig	lig
lih	lih
lii	lii
lij	lij
lik	lik
lil	lil
lim	lim
lin	lin
lio	lio
lip	lip
liq	liq
lir	lir
lis	lis
lit	lit
liu	liu
liv	liv
liw	liw
lix	lix
liy	liy
liz	liz
lja	lja
ljb	ljb
ljc	ljc
ljd	ljd
lje	lje
ljf	ljf
ljg	ljg
ljh	ljh
lji	lji
ljj	ljj
ljk	ljk
ljl	ljl
ljm	ljm
ljn	ljn
ljo	ljo
ljp	ljp
ljq	ljq
ljr	ljr
ljs	ljs
ljt	ljt
lju	lju
ljv	ljv
ljw	ljw
ljx	ljx
ljy	ljy
ljz	ljz
lka	lka
lkb	lkb
lkc	lkc
lkd	lkd
lke	lke
lkf	lkf
lkg	lkg
lkh	lkh
lki	lki
lkj	lkj
lkk	lkk
lkl	lkl
lkm	lkm
lkn	lkn
lko	lko
lkp	lkp
lkq	lkq
lkr	lkr
lks	lks
lkt	lkt
lku	lku
lkv	lkv
lkw	lkw
lkx	lkx
lky	lky
lkz	lkz
lla	lla
llb	llb
llc	llc
lld	lld
lle	lle
llf	llf
llg	llg
llh	llh
lli	lli
llj	llj
llk	llk
lll	lll
llm	llm
lln	lln
llo	llo
llp	llp
llq	llq
llr	llr
lls	lls
llt	llt
llu	llu
llv	llv
llw	llw
llx	llx
lly	lly
llz	llz
lma	lma
lmb	lmb
lmc	lmc
lmd	lmd
lme	lme
lmf	lmf
lmg	lmg
lmh	lmh
lmi	lmi
lmj	lmj
lmk	lmk
lml	lml
lmm	lmm
lmn	lmn
lmo	lmo
lmp	lmp
lmq	lmq
lmr	lmr
lms	lms
lmt	lmt
lmu	lmu
lmv	lmv
lmw	lmw
lmx	lmx
lmy	lmy
lmz	lmz
lna	lna
lnb	lnb
lnc	lnc
lnd	lnd
lne	lne
lnf	lnf
lng	lng
lnh	lnh
lni	lni
lnj	lnj
lnk	lnk
lnl	lnl
lnm	lnm
lnn	lnn
lno	lno
lnp	lnp
lnq	lnq
lnr	lnr
lns	lns
lnt	lnt
lnu	lnu
lnv	lnv
lnw	lnw
lnx	lnx
lny	lny
lnz	lnz
loa	loa
lob	lob
loc	loc
lod	lod
loe	loe
lof	lof
log	log
loh	loh
loi	loi
loj	loj
lok	lok
lol	lol
lom	lom
lon	lon
loo	loo
lop	lop
loq	loq
lor	lor
los	los
lot	lot
lou	lou
lov	lov
low	low
lox	lox
loy	loy
loz	loz
lpa	lpa
lpb	lpb
lpc	lpc
lpd	lpd
lpe	lpe
lpf	lpf
lpg	lpg
lph	lph
lpi	lpi
lpj	lpj
lpk	lpk
lpl	lpl
lpm	lpm
lpn	lpn
lpo	lpo
lpp	lpp
lpq	lpq
lpr	lpr
lps	lps
lpt	lpt
lpu	lpu
lpv	lpv
lpw	lpw
lpx	lpx
lpy	lpy
lpz	lpz
lqa	lqa
lqb	lqb
lqc	lqc
lqd	lqd
lqe	lqe
lqf	lqf
lqg	lqg
lqh	lqh
lqi	lqi
lqj	lqj
lqk	lqk
lql	lql
lqm	lqm
lqn	lqn
lqo	lqo
lqp	lqp
lqq	lqq
lqr	lqr
lqs	lqs
lqt	lqt
lqu	lqu
lqv	lqv
lqw	lqw
lqx	lqx
lqy	lqy
lqz	lqz
lra	lra
lrb	lrb
lrc	lrc
lrd	lrd
lre	lre
lrf	lrf
lrg	lrg
lrh	lrh
lri	lri
lrj	lrj
lrk	lrk
lrl	lrl
lrm	lrm
lrn	lrn
lro	lro
lrp	lrp
lrq	lrq
lrr	lrr
lrs	lrs
lrt	lrt
lru	lru
lrv	lrv
lrw	lrw
lrx	lrx
lry	lry
lrz	lrz
lsa	lsa
lsb	lsb
lsc	lsc
lsd	lsd
lse	lse
lsf	lsf
lsg	lsg
lsh	lsh
lsi	lsi
lsj	lsj
lsk	lsk
lsl	lsl
lsm	lsm
lsn	lsn
lso	lso
lsp	lsp
lsq	lsq
lsr	lsr
lss	lss
lst	lst
lsu	lsu
lsv	lsv
lsw	lsw
lsx	lsx
lsy	lsy
lsz	lsz
lta	lta
ltb	ltb
ltc	ltc
ltd	ltd
lte	lte
ltf	ltf
ltg	ltg
lth	lth
lti	lti
ltj	ltj
ltk	ltk
ltl	ltl
ltm	ltm
ltn	ltn
lto	lto
ltp	ltp
ltq	ltq
ltr	ltr
lts	lts
ltt	ltt
ltu	ltu
ltv	ltv
ltw	ltw
ltx	ltx
lty	lty
ltz	ltz
lua	lua
lub	lub
luc	luc
lud	lud
lue	lue
luf	luf
lug	lug
luh	luh
lui	lui
luj	luj
luk	luk
lul	lul
lum	lum
lun	lun
luo	luo
lup	lup
luq	luq
lur	lur
lus	lus
lut	lut
luu	luu
luv	luv
luw	luw
lux	lux
luy	luy
luz	luz
lva	lva
lvb	lvb
lvc	lvc
lvd	lvd
lve	lve
lvf	lvf
lvg	lvg
lvh	lvh
lvi	lvi
lvj	lvj
lvk	lvk
lvl	lvl
lvm	lvm
lvn	lvn
lvo	lvo
lvp	lvp
lvq	lvq
lvr	lvr
lvs	lvs
lvt	lvt
lvu	lvu
lvv	lvv
lvw	lvw
lvx	lvx
lvy	lvy
lvz	lvz
lwa	lwa
lwb	lwb
lwc	lwc
lwd	lwd
lwe	lwe
lwf	lwf
lwg	lwg
lwh	lwh
lwi	lwi
lwj	lwj
lwk	lwk
lwl	lwl
lwm	lwm
lwn	lwn
lwo	lwo
lwp	lwp
lwq	lwq
lwr	lwr
lws	lws
lwt	lwt
lwu	lwu
lwv	lwv
lww	lww
lwx	lwx
lwy	lwy
lwz	lwz
lxa	lxa
lxb	lxb
lxc	lxc
lxd	lxd
lxe	lxe
lxf	lxf
lxg	lxg
lxh	lxh
lxi	lxi
lxj	lxj
lxk	lxk
lxl	lxl
lxm	lxm
lxn	lxn
lxo	lxo
lxp	lxp
lxq	lxq
lxr	lxr
lxs	lxs
lxt	lxt
lxu	lxu
lxv	lxv
lxw	lxw
lxx	lxx
lxy	lxy
lxz	lxz
lya	lya
lyb	lyb
lyc	lyc
lyd	lyd
lye	lye
lyf	lyf
lyg	lyg
lyh	lyh
lyi	lyi
lyj	lyj
lyk	lyk
lyl	lyl
lym	lym
lyn	lyn
lyo	lyo
lyp	lyp
lyq	lyq
lyr	lyr
lys	lys
lyt	lyt
lyu	lyu
lyv	lyv
lyw	lyw
lyx	lyx
lyy	lyy
lyz	lyz
lza	lza
lzb	lzb
lzc	lzc
lzd	lzd
lze	lze
lzf	lzf
lzg	lzg
lzh	lzh
lzi	lzi
lzj	lzj
lzk	lzk
lzl	lzl
lzm	lzm
lzn	lzn
lzo	lzo
lzp	lzp
lzq	lzq
lzr	lzr
lzs	lzs
lzt	lzt
lzu	lzu
lzv	lzv
lzw	lzw
lzx	lzx
lzy	lzy
lzz	lzz
maa	maa
mab	mab
mac	mac
mad	mad
mae	mae
maf	maf
mag	mag
mah	mah
mai	mai
maj	maj
mak	mak
mal	mal
mam	mam
man	man
mao	mao
map	map
maq	maq
mar	mar
mas	mas
mat	mat
mau	mau
mav	mav
maw	maw
max	max
may	may
maz	maz
mba	mba
mbb	mbb
mbc	mbc
mbd	mbd
mbe	mbe
mbf	mbf
mbg	mbg
mbh	mbh
mbi	mbi
mbj	mbj
mbk	mbk
mbl	mbl
mbm	mbm
mbn	mbn
mbo	mbo
mbp	mbp
mbq	mbq
mbr	mbr
mbs	mbs
mbt	mbt
mbu	mbu
mbv	mbv
mbw	mbw
mbx	mbx
mby	mby
mbz	mbz
mca	mca
mcb	mcb
mcc	mcc
mcd	mcd
mce	mce
mcf	mcf
mcg	mcg
mch	mch
mci	mci
mcj	mcj
mck	mck
mcl	mcl
mcm	mcm
mcn	mcn
mco	mco
mcp	mcp
mcq	mcq
mcr	mcr
mcs	mcs
mct	mct
mcu	mcu
mcv	mcv
mcw	mcw
mcx	mcx
mcy	mcy
mcz	mcz
mda	mda
mdb	mdb
mdc	mdc
mdd	mdd
mde	mde
mdf	mdf
mdg	mdg
mdh	mdh
mdi	mdi
mdj	mdj
mdk	mdk
mdl	mdl
mdm	mdm
mdn	mdn
mdo	mdo
mdp	mdp
mdq	mdq
mdr	mdr
mds	mds
mdt	mdt
mdu	mdu
mdv	mdv
mdw	mdw
mdx	mdx
mdy	mdy
mdz	mdz
mea	mea
meb	meb
mec	mec
med	med
mee	mee
mef	mef
meg	meg
meh	meh
mei	mei
mej	mej
mek	mek
mel	mel
mem	mem
men	men
meo	meo
mep	mep
meq	meq
mer	mer
mes	mes
met	met
meu	meu
mev	mev
mew	mew
mex	mex
mey	mey
mez	mez
mfa	mfa
mfb	mfb
mfc	mfc
mfd	mfd
mfe	mfe
mff	mff
mfg	mfg
mfh	mfh
mfi	mfi
mfj	mfj
mfk	mfk
mfl	mfl
mfm	mfm
mfn	mfn
mfo	mfo
mfp	mfp
mfq	mfq
mfr	mfr
mfs	mfs
mft	mft
mfu	mfu
mfv	mfv
mfw	mfw
mfx	mfx
mfy	mfy
mfz	mfz
mga	mga
mgb	mgb
mgc	mgc
mgd	mgd
mge	mge
mgf	mgf
mgg	mgg
mgh	mgh
mgi	mgi
mgj	mgj
mgk	mgk
mgl	mgl
mgm	mgm
mgn	mgn
mgo	mgo
mgp	mgp
mgq	mgq
mgr	mgr
mgs	mgs
mgt	mgt
mgu	mgu
mgv	mgv
mgw	mgw
mgx	mgx
mgy	mgy
mgz	mgz
mha	mha
mhb	mhb
mhc	mhc
mhd	mhd
mhe	mhe
mhf	mhf
mhg	mhg
mhh	mhh
mhi	mhi
mhj	mhj
mhk	mhk
mhl	mhl
mhm	mhm
mhn	mhn
mho	mho
mhp	mhp
mhq	mhq
mhr	mhr
mhs	mhs
mht	mht
mhu	mhu
mhv	mhv
mhw	mhw
mhx	mhx
mhy	mhy
mhz	mhz
mia	mia
mib	mib
mic	mic
mid	mid
mie	mie
mif	mif
mig	mig
mih	mih
mii	mii
mij	mij
mik	mik
mil	mil
mim	mim
min	min
mio	mio
mip	mip
miq	miq
mir	mir
mis	mis
mit	mit
miu	miu
miv	miv
miw	miw
mix	mix
miy	miy
miz	miz
mja	mja
mjb	mjb
mjc	mjc
mjd	mjd
mje	mje
mjf	mjf
mjg	mjg
mjh	mjh
mji	mji
mjj	mjj
mjk	mjk
mjl	mjl
mjm	mjm
mjn	mjn
mjo	mjo
mjp	mjp
mjq	mjq
mjr	mjr
mjs	mjs
mjt	mjt
mju	mju
mjv	mjv
mjw	mjw
mjx	mjx
mjy	mjy
mjz	mjz
mka	mka
mkb	mkb
mkc	mkc
mkd	mkd
mke	mke
mkf	mkf
mkg	mkg
mkh	mkh
mki	mki
mkj	mkj
mkk	mkk
mkl	mkl
mkm	mkm
mkn	mkn
mko	mko
mkp	mkp
mkq	mkq
mkr	mkr
mks	mks
mkt	mkt
mku	mku
mkv	mkv
mkw	mkw
mkx	mkx
mky	mky
mkz	mkz
mla	mla
mlb	mlb
mlc	mlc
mld	mld
mle	mle
mlf	mlf
mlg	mlg
mlh	mlh
mli	mli
mlj	mlj
mlk	mlk
mll	mll
mlm	mlm
mln	mln
mlo	mlo
mlp	mlp
mlq	mlq
mlr	mlr
mls	mls
mlt	mlt
mlu	mlu
mlv	mlv
mlw	mlw
mlx	mlx
mly	mly
mlz	mlz
mma	mma
mmb	mmb
mmc	mmc
mmd	mmd
mme	mme
mmf	mmf
mmg	mmg
mmh	mmh
mmi	mmi
mmj	mmj
mmk	mmk
mml	mml
mmm	mmm
mmn	mmn
mmo	mmo
mmp	mmp
mmq	mmq
mmr	mmr
mms	mms
mmt	mmt
mmu	mmu
mmv	mmv
mmw	mmw
mmx	mmx
mmy	mmy
mmz	mmz
mna	mna
mnb	mnb
mnc	mnc
mnd	mnd
mne	mne
mnf	mnf
mng	mng
mnh	mnh
mni	mni
mnj	mnj
mnk	mnk
mnl	mnl
mnm	mnm
mnn	mnn
mno	mno
mnp	mnp
mnq	mnq
mnr	mnr
mns	mns
mnt	mnt
mnu	mnu
mnv	mnv
mnw	mnw
mnx	mnx
mny	mny
mnz	mnz
moa	moa
mob	mob
moc	moc
mod	mod
moe	moe
mof	mof
mog	mog
moh	moh
moi	moi
moj	moj
mok	mok
mol	mol
mom	mom
mon	mon
moo	moo
mop	mop
moq	moq
mor	mor
mos	mos
mot	mot
mou	mou
mov	mov
mow	mow
mox	mox
moy	moy
moz	moz
mpa	mpa
mpb	mpb
mpc	mpc
mpd	mpd
mpe	mpe
mpf	mpf
mpg	mpg
mph	mph
mpi	mpi
mpj	mpj
mpk	mpk
mpl	mpl
mpm	mpm
mpn	mpn
mpo	mpo
mpp	mpp
mpq	mpq
mpr	mpr
mps	mps
mpt	mpt
mpu	mpu
mpv	mpv
mpw	mpw
mpx	mpx
mpy	mpy
mpz	mpz
mqa	mqa
mqb	mqb
mqc	mqc
mqd	mqd
mqe	mqe
mqf	mqf
mqg	mqg
mqh	mqh
mqi	mqi
mqj	mqj
mqk	mqk
mql	mql
mqm	mqm
mqn	mqn
mqo	mqo
mqp	mqp
mqq	mqq
mqr	mqr
mqs	mqs
mqt	mqt
mqu	mqu
mqv	mqv
mqw	mqw
mqx	mqx
mqy	mqy
mqz	mqz
mra	mra
mrb	mrb
mrc	mrc
mrd	mrd
mre	mre
mrf	mrf
mrg	mrg
mrh	mrh
mri	mri
mrj	mrj
mrk	mrk
mrl	mrl
mrm	mrm
mrn	mrn
mro	mro
mrp	mrp
mrq	mrq
mrr	mrr
mrs	mrs
mrt	mrt
mru	mru
mrv	mrv
mrw	mrw
mrx	mrx
mry	mry
mrz	mrz
msa	msa
msb	msb
msc	msc
msd	msd
mse	mse
msf	msf
msg	msg
msh	msh
msi	msi
msj	msj
msk	msk
msl	msl
msm	msm
msn	msn
mso	mso
msp	msp
msq	msq
msr	msr
mss	mss
mst	mst
msu	msu
msv	msv
msw	msw
msx	msx
msy	msy
msz	msz
mta	mta
mtb	mtb
mtc	mtc
mtd	mtd
mte	mte
mtf	mtf
mtg	mtg
mth	mth
mti	mti
mtj	mtj
mtk	mtk
mtl	mtl
mtm	mtm
mtn	mtn
mto	mto
mtp	mtp
mtq	mtq
mtr	mtr
mts	mts
mtt	mtt
mtu	mtu
mtv	mtv
mtw	mtw
mtx	mtx
mty	mty
mtz	mtz
mua	mua
mub	mub
muc	muc
mud	mud
mue	mue
muf	muf
mug	mug
muh	muh
mui	mui
muj	muj
muk	muk
mul	mul
mum	mum
mun	mun
muo	muo
mup	mup
muq	muq
mur	mur
mus	mus
mut	mut
muu	muu
muv	muv
muw	muw
mux	mux
muy	muy
muz	muz
mva	mva
mvb	mvb
mvc	mvc
mvd	mvd
mve	mve
mvf	mvf
mvg	mvg
mvh	mvh
mvi	mvi
mvj	mvj
mvk	mvk
mvl	mvl
mvm	mvm
mvn	mvn
mvo	mvo
mvp	mvp
mvq	mvq
mvr	mvr
mvs	mvs
mvt	mvt
mvu	mvu
mvv	mvv
mvw	mvw
mvx	mvx
mvy	mvy
mvz	mvz
mwa	mwa
mwb	mwb
mwc	mwc
mwd	mwd
mwe	mwe
mwf	mwf
mwg	mwg
mwh	mwh
mwi	mwi
mwj	mwj
mwk	mwk
mwl	mwl
mwm	mwm
mwn	mwn
mwo	mwo
mwp	mwp
mwq	mwq
mwr	mwr
mws	mws
mwt	mwt
mwu	mwu
mwv	mwv
mww	mww
mwx	mwx
mwy	mwy
mwz	mwz
mxa	mxa
mxb	mxb
mxc	mxc
mxd	mxd
mxe	mxe
mxf	mxf
mxg	mxg
mxh	mxh
mxi	mxi
mxj	mxj
mxk	mxk
mxl	mxl
mxm	mxm
mxn	mxn
mxo	mxo
mxp	mxp
mxq	mxq
mxr	mxr
mxs	mxs
mxt	mxt
mxu	mxu
mxv	mxv
mxw	mxw
mxx	mxx
mxy	mxy
mxz	mxz
mya	mya
myb	myb
myc	myc
myd	myd
mye	mye
myf	myf
myg	myg
myh	myh
myi	myi
myj	myj
myk	myk
myl	myl
mym	mym
myn	myn
myo	myo
myp	myp
myq	myq
myr	myr
mys	mys
myt	myt
myu	myu
myv	myv
myw	myw
myx	myx
myy	myy
myz	myz
mza	mza
mzb	mzb
mzc	mzc
mzd	mzd
mze	mze
mzf	mzf
mzg	mzg
mzh	mzh
mzi	mzi
mzj	mzj
mzk	mzk
mzl	mzl
mzm	mzm
mzn	mzn
mzo	mzo
mzp	mzp
mzq	mzq
mzr	mzr
mzs	mzs
mzt	mzt
mzu	mzu
mzv	mzv
mzw	mzw
mzx	mzx
mzy	mzy
mzz	mzz
naa	naa
nab	nab
nac	nac
nad	nad
nae	nae
naf	naf
nag	nag
nah	nah
nai	nai
naj	naj
nak	nak
nal	nal
nam	nam
nan	nan
nao	nao
nap	nap
naq	naq
nar	nar
nas	nas
nat	nat
nau	nau
nav	nav
naw	naw
nax	nax
nay	nay
naz	naz
nba	nba
nbb	nbb
nbc	nbc
nbd	nbd
nbe	nbe
nbf	nbf
nbg	nbg
nbh	nbh
nbi	nbi
nbj	nbj
nbk	nbk
nbl	nbl
nbm	nbm
nbn	nbn
nbo	nbo
nbp	nbp
nbq	nbq
nbr	nbr
nbs	nbs
nbt	nbt
nbu	nbu
nbv	nbv
nbw	nbw
nbx	nbx
nby	nby
nbz	nbz
nca	nca
ncb	ncb
ncc	ncc
ncd	ncd
nce	nce
ncf	ncf
ncg	ncg
nch	nch
nci	nci
ncj	ncj
nck	nck
ncl	ncl
ncm	ncm
ncn	ncn
nco	nco
ncp	ncp
ncq	ncq
ncr	ncr
ncs	ncs
nct	nct
ncu	ncu
ncv	ncv
ncw	ncw
ncx	ncx
ncy	ncy
ncz	ncz
nda	nda
ndb	ndb
ndc	ndc
ndd	ndd
nde	nde
ndf	ndf
ndg	ndg
ndh	ndh
ndi	ndi
ndj	ndj
ndk	ndk
ndl	ndl
ndm	ndm
ndn	ndn
ndo	ndo
ndp	ndp
ndq	ndq
ndr	ndr
nds	nds
ndt	ndt
ndu	ndu
ndv	ndv
ndw	ndw
ndx	ndx
ndy	ndy
ndz	ndz
nea	nea
neb	neb
nec	nec
ned	ned
nee	nee
nef	nef
neg	neg
neh	neh
nei	nei
nej	nej
nek	nek
nel	nel
nem	nem
nen	nen
neo	neo
nep	nep
neq	neq
ner	ner
nes	nes
net	net
neu	neu
nev	nev
new	new
nex	nex
ney	ney
nez	nez
nfa	nfa
nfb	nfb
nfc	nfc
nfd	nfd
nfe	nfe
nff	nff
nfg	nfg
nfh	nfh
nfi	nfi
nfj	nfj
nfk	nfk
nfl	nfl
nfm	nfm
nfn	nfn
nfo	nfo
nfp	nfp
nfq	nfq
nfr	nfr
nfs	nfs
nft	nft
nfu	nfu
nfv	nfv
nfw	nfw
nfx	nfx
nfy	nfy
nfz	nfz
nga	nga
ngb	ngb
ngc	ngc
ngd	ngd
nge	nge
ngf	ngf
ngg	ngg
ngh	ngh
ngi	ngi
ngj	ngj
ngk	ngk
ngl	ngl
ngm	ngm
ngn	ngn
ngo	ngo
ngp	ngp
ngq	ngq
ngr	ngr
ngs	ngs
ngt	ngt
ngu	ngu
ngv	ngv
ngw	ngw
ngx	ngx
ngy	ngy
ngz	ngz
nha	nha
nhb	nhb
nhc	nhc
nhd	nhd
nhe	nhe
nhf	nhf
nhg	nhg
nhh	nhh
nhi	nhi
nhj	nhj
nhk	nhk
nhl	nhl
nhm	nhm
nhn	nhn
nho	nho
nhp	nhp
nhq	nhq
nhr	nhr
nhs	nhs
nht	nht
nhu	nhu
nhv	nhv
nhw	nhw
nhx	nhx
nhy	nhy
nhz	nhz
nia	nia
nib	nib
nic	nic
nid	nid
nie	nie
nif	nif
nig	nig
nih	nih
nii	nii
nij	nij
nik	nik
nil	nil
nim	nim
nin	nin
nio	nio
nip	nip
niq	niq
nir	nir
nis	nis
nit	nit
niu	niu
niv	niv
niw	niw
nix	nix
niy	niy
niz	niz
nja	nja
njb	njb
njc	njc
njd	njd
nje	nje
njf	njf
njg	njg
njh	njh
nji	nji
njj	njj
njk	njk
njl	njl
njm	njm
njn	njn
njo	njo
njp	njp
njq	njq
njr	njr
njs	njs
njt	njt
nju	nju
njv	njv
njw	njw
njx	njx
njy	njy
njz	njz
nka	nka
nkb	nkb
nkc	nkc
nkd	nkd
nke	nke
nkf	nkf
nkg	nkg
nkh	nkh
nki	nki
nkj	nkj
nkk	nkk
nkl	nkl
nkm	nkm
nkn	nkn
nko	nko
nkp	nkp
nkq	nkq
nkr	nkr
nks	nks
nkt	nkt
nku	nku
nkv	nkv
nkw	nkw
nkx	nkx
nky	nky
nkz	nkz
nla	nla
nlb	nlb
nlc	nlc
nld	nld
nle	nle
nlf	nlf
nlg	nlg
nlh	nlh
nli	nli
nlj	nlj
nlk	nlk
nll	nll
nlm	nlm
nln	nln
nlo	nlo
nlp	nlp
nlq	nlq
nlr	nlr
nls	nls
nlt	nlt
nlu	nlu
nlv	nlv
nlw	nlw
nlx	nlx
nly	nly
nlz	nlz
nma	nma
nmb	nmb
nmc	nmc
nmd	nmd
nme	nme
nmf	nmf
nmg	nmg
nmh	nmh
nmi	nmi
nmj	nmj
nmk	nmk
nml	nml
nmm	nmm
nmn	nmn
nmo	nmo
nmp	nmp
nmq	nmq
nmr	nmr
nms	nms
nmt	nmt
nmu	nmu
nmv	nmv
nmw	nmw
nmx	nmx
nmy	nmy
nmz	nmz
nna	nna
nnb	nnb
nnc	nnc
nnd	nnd
nne	nne
nnf	nnf
nng	nng
nnh	nnh
nni	nni
nnj	nnj
nnk	nnk
nnl	nnl
nnm	nnm
nnn	nnn
nno	nno
nnp	nnp
nnq	nnq
nnr	nnr
nns	nns
nnt	nnt
nnu	nnu
nnv	nnv
nnw	nnw
nnx	nnx
nny	nny
nnz	nnz
noa	noa
nob	nob
noc	noc
nod	nod
noe	noe
nof	nof
nog	nog
noh	noh
noi	noi
noj	noj
nok	nok
nol	nol
nom	nom
non	non
noo	noo
nop	nop
noq	noq
nor	nor
nos	nos
not	not
nou	nou
nov	nov
now	now
nox	nox
noy	noy
noz	noz
npa	npa
npb	npb
npc	npc
npd	npd
npe	npe
npf	npf
npg	npg
nph	nph
npi	npi
npj	npj
npk	npk
npl	npl
npm	npm
npn	npn
npo	npo
npp	npp
npq	npq
npr	npr
nps	nps
npt	npt
npu	npu
npv	npv
npw	npw
npx	npx
npy	npy
npz	npz
nqa	nqa
nqb	nqb
nqc	nqc
nqd	nqd
nqe	nqe
nqf	nqf
nqg	nqg
nqh	nqh
nqi	nqi
nqj	nqj
nqk	nqk
nql	nql
nqm	nqm
nqn	nqn
nqo	nqo
nqp	nqp
nqq	nqq
nqr	nqr
nqs	nqs
nqt	nqt
nqu	nqu
nqv	nqv
nqw	nqw
nqx	nqx
nqy	nqy
nqz	nqz
nra	nra
nrb	nrb
nrc	nrc
nrd	nrd
nre	nre
nrf	nrf
nrg	nrg
nrh	nrh
nri	nri
nrj	nrj
nrk	nrk
nrl	nrl
nrm	nrm
nrn	nrn
nro	nro
nrp	nrp
nrq	nrq
nrr	nrr
nrs	nrs
nrt	nrt
nru	nru
nrv	nrv
nrw	nrw
nrx	nrx
nry	nry
nrz	nrz
nsa	nsa
nsb	nsb
nsc	nsc
nsd	nsd
nse	nse
nsf	nsf
nsg	nsg
nsh	nsh
nsi	nsi
nsj	nsj
nsk	nsk
nsl	nsl
nsm	nsm
nsn	nsn
nso	nso
nsp	nsp
nsq	nsq
nsr	nsr
nss	nss
nst	nst
nsu	nsu
nsv	nsv
nsw	nsw
nsx	nsx
nsy	nsy
nsz	nsz
nta	nta
ntb	ntb
ntc	ntc
ntd	ntd
nte	nte
ntf	ntf
ntg	ntg
nth	nth
nti	nti
ntj	ntj
ntk	ntk
ntl	ntl
ntm	ntm
ntn	ntn
nto	nto
ntp	ntp
ntq	ntq
ntr	ntr
nts	nts
ntt	ntt
ntu	ntu
ntv	ntv
ntw	ntw
ntx	ntx
nty	nty
ntz	ntz
nua	nua
nub	nub
nuc	nuc
nud	nud
nue	nue
nuf	nuf
nug	nug
nuh	nuh
nui	nui
nuj	nuj
nuk	nuk
nul	nul
num	num
nun	nun
nuo	nuo
nup	nup
nuq	nuq
nur	nur
nus	nus
nut	nut
nuu	nuu
nuv	nuv
nuw	nuw
nux	nux
nuy	nuy
nuz	nuz
nva	nva
nvb	nvb
nvc	nvc
nvd	nvd
nve	nve
nvf	nvf
nvg	nvg
nvh	nvh
nvi	nvi
nvj	nvj
nvk	nvk
nvl	nvl
nvm	nvm
nvn	nvn
nvo	nvo
nvp	nvp
nvq	nvq
nvr	nvr
nvs	nvs
nvt	nvt
nvu	nvu
nvv	nvv
nvw	nvw
nvx	nvx
nvy	nvy
nvz	nvz
nwa	nwa
nwb	nwb
nwc	nwc
nwd	nwd
nwe	nwe
nwf	nwf
nwg	nwg
nwh	nwh
nwi	nwi
nwj	nwj
nwk	nwk
nwl	nwl
nwm	nwm
nwn	nwn
nwo	nwo
nwp	nwp
nwq	nwq
nwr	nwr
nws	nws
nwt	nwt
nwu	nwu
nwv	nwv
nww	nww
nwx	nwx
nwy	nwy
nwz	nwz
nxa	nxa
nxb	nxb
nxc	nxc
nxd	nxd
nxe	nxe
nxf	nxf
nxg	nxg
nxh	nxh
nxi	nxi
nxj	nxj
nxk	nxk
nxl	nxl
nxm	nxm
nxn	nxn
nxo	nxo
nxp	nxp
nxq	nxq
nxr	nxr
nxs	nxs
nxt	nxt
nxu	nxu
nxv	nxv
nxw	nxw
nxx	nxx
nxy	nxy
nxz	nxz
nya	nya
nyb	nyb
nyc	nyc
nyd	nyd
nye	nye
nyf	nyf
nyg	nyg
nyh	nyh
nyi	nyi
nyj	nyj
nyk	nyk
nyl	nyl
nym	nym
nyn	nyn
nyo	nyo
nyp	nyp
nyq	nyq
nyr	nyr
nys	nys
nyt	nyt
nyu	nyu
nyv	nyv
nyw	nyw
nyx	nyx
nyy	nyy
nyz	nyz
nza	nza
nzb	nzb
nzc	nzc
nzd	nzd
nze	nze
nzf	nzf
nzg	nzg
nzh	nzh
nzi	nzi
nzj	nzj
nzk	nzk
nzl	nzl
nzm	nzm
nzn	nzn
nzo	nzo
nzp	nzp
nzq	nzq
nzr	nzr
nzs	nzs
nzt	nzt
nzu	nzu
nzv	nzv
nzw	nzw
nzx	nzx
nzy	nzy
nzz	nzz
oaa	oaa
oab	oab
oac	oac
oad	oad
oae	oae
oaf	oaf
oag	oag
oah	oah
oai	oai
oaj	oaj
oak	oak
oal	oal
oam	oam
oan	oan
oao	oao
oap	oap
oaq	oaq
oar	oar
oas	oas
oat	oat
oau	oau
oav	oav
oaw	oaw
oax	oax
oay	oay
oaz	oaz
oba	oba
obb	obb
obc	obc
obd	obd
obe	obe
obf	obf
obg	obg
obh	obh
obi	obi
obj	obj
obk	obk
obl	obl
obm	obm
obn	obn
obo	obo
obp	obp
obq	obq
obr	obr
obs	obs
obt	obt
obu	obu
obv	obv
obw	obw
obx	obx
oby	oby
obz	obz
oca	oca
ocb	ocb
occ	occ
ocd	ocd
oce	oce
ocf	ocf
ocg	ocg
och	och
oci	oci
ocj	ocj
ock	ock
ocl	ocl
ocm	ocm
ocn	ocn
oco	oco
ocp	ocp
ocq	ocq
ocr	ocr
ocs	ocs
oct	oct
ocu	ocu
ocv	ocv
ocw	ocw
ocx	ocx
ocy	ocy
ocz	ocz
oda	oda
odb	odb
odc	odc
odd	odd
ode	ode
odf	odf
odg	odg
odh	odh
odi	odi
odj	odj
odk	odk
odl	odl
odm	odm
odn	odn
odo	odo
odp	odp
odq	odq
odr	odr
ods	ods
odt	odt
odu	odu
odv	odv
odw	odw
odx	odx
ody	ody
odz	odz
oea	oea
oeb	oeb
oec	oec
oed	oed
oee	oee
oef	oef
oeg	oeg
oeh	oeh
oei	oei
oej	oej
oek	oek
oel	oel
oem	oem
oen	oen
oeo	oeo
oep	oep
oeq	oeq
oer	oer
oes	oes
oet	oet
oeu	oeu
oev	oev
oew	oew
oex	oex
oey	oey
oez	oez
ofa	ofa
ofb	ofb
ofc	ofc
ofd	ofd
ofe	ofe
off	off
ofg	ofg
ofh	ofh
ofi	ofi
ofj	ofj
ofk	ofk
ofl	ofl
ofm	ofm
ofn	ofn
ofo	ofo
ofp	ofp
ofq	ofq
ofr	ofr
ofs	ofs
oft	oft
ofu	ofu
ofv	ofv
ofw	ofw
ofx	ofx
ofy	ofy
ofz	ofz
oga	oga
ogb	ogb
ogc	ogc
ogd	ogd
oge	oge
ogf	ogf
ogg	ogg
ogh	ogh
ogi	ogi
ogj	ogj
ogk	ogk
ogl	ogl
ogm	ogm
ogn	ogn
ogo	ogo
ogp	ogp
ogq	ogq
ogr	ogr
ogs	ogs
ogt	ogt
ogu	ogu
ogv	ogv
ogw	ogw
ogx	ogx
ogy	ogy
ogz	ogz
oha	oha
ohb	ohb
ohc	ohc
ohd	ohd
ohe	ohe
ohf	ohf
ohg	ohg
ohh	ohh
ohi	ohi
ohj	ohj
ohk	ohk
ohl	ohl
ohm	ohm
ohn	ohn
oho	oho
ohp	ohp
ohq	ohq
ohr	ohr
ohs	ohs
oht	oht
ohu	ohu
ohv	ohv
ohw	ohw
ohx	ohx
ohy	ohy
ohz	ohz
oia	oia
oib	oib
oic	oic
oid	oid
oie	oie
oif	oif
oig	oig
oih	oih
oii	oii
oij	oij
oik	oik
oil	oil
oim	oim
oin	oin
oio	oio
oip	oip
oiq	oiq
oir	oir
ois	ois
oit	oit
oiu	oiu
oiv	oiv
oiw	oiw
oix	oix
oiy	oiy
oiz	oiz
oja	oja
ojb	ojb
ojc	ojc
ojd	ojd
oje	oje
ojf	ojf
ojg	ojg
ojh	ojh
oji	oji
ojj	ojj
ojk	ojk
ojl	ojl
ojm	ojm
ojn	ojn
ojo	ojo
ojp	ojp
ojq	ojq
ojr	ojr
ojs	ojs
ojt	ojt
oju	oju
ojv	ojv
ojw	ojw
ojx	ojx
ojy	ojy
ojz	ojz
oka	oka
okb	okb
okc	okc
okd	okd
oke	oke
okf	okf
okg	okg
okh	okh
oki	oki
okj	okj
okk	okk
okl	okl
okm	okm
okn	okn
oko	oko
okp	okp
okq	okq
okr	okr
oks	oks
okt	okt
oku	oku
okv	okv
okw	okw
okx	okx
oky	oky
okz	okz
ola	ola
olb	olb
olc	olc
old	old
ole	ole
olf	olf
olg	olg
olh	olh
oli	oli
olj	olj
olk	olk
oll	oll
olm	olm
oln	oln
olo	olo
olp	olp
olq	olq
olr	olr
ols	ols
olt	olt
olu	olu
olv	olv
olw	olw
olx	olx
oly	oly
olz	olz
oma	oma
omb	omb
omc	omc
omd	omd
ome	ome
omf	omf
omg	omg
omh	omh
omi	omi
omj	omj
omk	omk
oml	oml
omm	omm
omn	omn
omo	omo
omp	omp
omq	omq
omr	omr
oms	oms
omt	omt
omu	omu
omv	omv
omw	omw
omx	omx
omy	omy
omz	omz
ona	ona
onb	onb
onc	onc
ond	ond
one	one
onf	onf
ong	ong
onh	onh
oni	oni
onj	onj
onk	onk
onl	onl
onm	onm
onn	onn
ono	ono
onp	onp
onq	onq
onr	onr
ons	ons
ont	ont
onu	onu
onv	onv
onw	onw
onx	onx
ony	ony
onz	onz
ooa	ooa
oob	oob
ooc	ooc
ood	ood
ooe	ooe
oof	oof
oog	oog
ooh	ooh
ooi	ooi
ooj	ooj
ook	ook
ool	ool
oom	oom
oon	oon
ooo	ooo
oop	oop
ooq	ooq
oor	oor
oos	oos
oot	oot
oou	oou
oov	oov
oow	oow
oox	oox
ooy	ooy
ooz	ooz
opa	opa
opb	opb
opc	opc
opd	opd
ope	ope
opf	opf
opg	opg
oph	oph
opi	opi
opj	opj
opk	opk
opl	opl
opm	opm
opn	opn
opo	opo
opp	opp
opq	opq
opr	opr
ops	ops
opt	opt
opu	opu
opv	opv
opw	opw
opx	opx
opy	opy
opz	opz
oqa	oqa
oqb	oqb
oqc	oqc
oqd	oqd
oqe	oqe
oqf	oqf
oqg	oqg
oqh	oqh
oqi	oqi
oqj	oqj
oqk	oqk
oql	oql
oqm	oqm
oqn	oqn
oqo	oqo
oqp	oqp
oqq	oqq
oqr	oqr
oqs	oqs
oqt	oqt
oqu	oqu
oqv	oqv
oqw	oqw
oqx	oqx
oqy	oqy
oqz	oqz
ora	ora
orb	orb
orc	orc
ord	ord
ore	ore
orf	orf
org	org
orh	orh
ori	ori
orj	orj
ork	ork
orl	orl
orm	orm
orn	orn
oro	oro
orp	orp
orq	orq
orr	orr
ors	ors
ort	ort
oru	oru
orv	orv
orw	orw
orx	orx
ory	ory
orz	orz
osa	osa
osb	osb
osc	osc
osd	osd
ose	ose
osf	osf
osg	osg
osh	osh
osi	osi
osj	osj
osk	osk
osl	osl
osm	osm
osn	osn
oso	oso
osp	osp
osq	osq
osr	osr
oss	oss
ost	ost
osu	osu
osv	osv
osw	osw
osx	osx
osy	osy
osz	osz
ota	ota
otb	otb
otc	otc
otd	otd
ote	ote
otf	otf
otg	otg
oth	oth
oti	oti
otj	otj
otk	otk
otl	otl
otm	otm
otn	otn
oto	oto
otp	otp
otq	otq
otr	otr
ots	ots
ott	ott
otu	otu
otv	otv
otw	otw
otx	otx
oty	oty
otz	otz
oua	oua
oub	oub
ouc	ouc
oud	oud
oue	oue
ouf	ouf
oug	oug
ouh	ouh
oui	oui
ouj	ouj
ouk	ouk
oul	oul
oum	oum
oun	oun
ouo	ouo
oup	oup
ouq	ouq
our	our
ous	ous
out	out
ouu	ouu
ouv	ouv
ouw	ouw
oux	oux
ouy	ouy
ouz	ouz
ova	ova
ovb	ovb
ovc	ovc
ovd	ovd
ove	ove
ovf	ovf
ovg	ovg
ovh	ovh
ovi	ovi
ovj	ovj
ovk	ovk
ovl	ovl
ovm	ovm
ovn	ovn
ovo	ovo
ovp	ovp
ovq	ovq
ovr	ovr
ovs	ovs
ovt	ovt
ovu	ovu
ovv	ovv
ovw	ovw
ovx	ovx
ovy	ovy
ovz	ovz
owa	owa
owb	owb
owc	owc
owd	owd
owe	owe
owf	owf
owg	owg
owh	owh
owi	owi
owj	owj
owk	owk
owl	owl
owm	owm
own	own
owo	owo
owp	owp
owq	owq
owr	owr
ows	ows
owt	owt
owu	owu
owv	owv
oww	oww
owx	owx
owy	owy
owz	owz
oxa	oxa
oxb	oxb
oxc	oxc
oxd	oxd
oxe	oxe
oxf	oxf
oxg	oxg
oxh	oxh
oxi	oxi
oxj	oxj
oxk	oxk
oxl	oxl
oxm	oxm
oxn	oxn
oxo	oxo
oxp	oxp
oxq	oxq
oxr	oxr
oxs	oxs
oxt	oxt
oxu	oxu
oxv	oxv
oxw	oxw
oxx	oxx
oxy	oxy
oxz	oxz
oya	oya
oyb	oyb
oyc	oyc
oyd	oyd
oye	oye
oyf	oyf
oyg	oyg
oyh	oyh
oyi	oyi
oyj	oyj
oyk	oyk
oyl	oyl
oym	oym
oyn	oyn
oyo	oyo
oyp	oyp
oyq	oyq
oyr	oyr
oys	oys
oyt	oyt
oyu	oyu
oyv	oyv
oyw	oyw
oyx	oyx
oyy	oyy
oyz	oyz
oza	oza
ozb	ozb
ozc	ozc
ozd	ozd
oze	oze
ozf	ozf
ozg	ozg
ozh	ozh
ozi	ozi
ozj	ozj
ozk	ozk
ozl	ozl
ozm	ozm
ozn	ozn
ozo	ozo
ozp	ozp
ozq	ozq
ozr	ozr
ozs	ozs
ozt	ozt
ozu	ozu
ozv	ozv
ozw	ozw
ozx	ozx
ozy	ozy
ozz	ozz
paa	paa
pab	pab
pac	pac
pad	pad
pae	pae
paf	paf
pag	pag
pah	pah
pai	pai
paj	paj
pak	pak
pal	pal
pam	pam
pan	pan
pao	pao
pap	pap
paq	paq
par	par
pas	pas
pat	pat
pau	pau
pav	pav
paw	paw
pax	pax
pay	pay
paz	paz
pba	pba
pbb	pbb
pbc	pbc
pbd	pbd
pbe	pbe
pbf	pbf
pbg	pbg
pbh	pbh
pbi	pbi
pbj	pbj
pbk	pbk
pbl	pbl
pbm	pbm
pbn	pbn
pbo	pbo
pbp	pbp
pbq	pbq
pbr	pbr
pbs	pbs
pbt	pbt
pbu	pbu
pbv	pbv
pbw	pbw
pbx	pbx
pby	pby
pbz	pbz
pca	pca
pcb	pcb
pcc	pcc
pcd	pcd
pce	pce
pcf	pcf
pcg	pcg
pch	pch
pci	pci
pcj	pcj
pck	pck
pcl	pcl
pcm	pcm
pcn	pcn
pco	pco
pcp	pcp
pcq	pcq
pcr	pcr
pcs	pcs
pct	pct
pcu	pcu
pcv	pcv
pcw	pcw
pcx	pcx
pcy	pcy
pcz	pcz
pda	pda
pdb	pdb
pdc	pdc
pdd	pdd
pde	pde
pdf	pdf
pdg	pdg
pdh	pdh
pdi	pdi
pdj	pdj
pdk	pdk
pdl	pdl
pdm	pdm
pdn	pdn
pdo	pdo
pdp	pdp
pdq	pdq
pdr	pdr
pds	pds
pdt	pdt
pdu	pdu
pdv	pdv
pdw	pdw
pdx	pdx
pdy	pdy
pdz	pdz
pea	pea
peb	peb
pec	pec
ped	ped
pee	pee
pef	pef
peg	peg
peh	peh
pei	pei
pej	pej
pek	pek
pel	pel
pem	pem
pen	pen
peo	peo
pep	pep
peq	peq
per	per
pes	pes
pet	pet
peu	peu
pev	pev
pew	pew
pex	pex
pey	pey
pez	pez
pfa	pfa
pfb	pfb
pfc	pfc
pfd	pfd
pfe	pfe
pff	pff
pfg	pfg
pfh	pfh
pfi	pfi
pfj	pfj
pfk	pfk
pfl	pfl
pfm	pfm
pfn	pfn
pfo	pfo
pfp	pfp
pfq	pfq
pfr	pfr
pfs	pfs
pft	pft
pfu	pfu
pfv	pfv
pfw	pfw
pfx	pfx
pfy	pfy
pfz	pfz
pga	pga
pgb	pgb
pgc	pgc
pgd	pgd
pge	pge
pgf	pgf
pgg	pgg
pgh	pgh
pgi	pgi
pgj	pgj
pgk	pgk
pgl	pgl
pgm	pgm
pgn	pgn
pgo	pgo
pgp	pgp
pgq	pgq
pgr	pgr
pgs	pgs
pgt	pgt
pgu	pgu
pgv	pgv
pgw	pgw
pgx	pgx
pgy	pgy
pgz	pgz
pha	pha
phb	phb
phc	phc
phd	phd
phe	phe
phf	phf
phg	phg
phh	phh
phi	phi
phj	phj
phk	phk
phl	phl
phm	phm
phn	phn
pho	pho
php	php
phq	phq
phr	phr
phs	phs
pht	pht
phu	phu
phv	phv
phw	phw
phx	phx
phy	phy
phz	phz
pia	pia
pib	pib
pic	pic
pid	pid
pie	pie
pif	pif
pig	pig
pih	pih
pii	pii
pij	pij
pik	pik
pil	pil
pim	pim
pin	pin
pio	pio
pip	pip
piq	piq
pir	pir
pis	pis
pit	pit
piu	piu
piv	piv
piw	piw
pix	pix
piy	piy
piz	piz
pja	pja
pjb	pjb
pjc	pjc
pjd	pjd
pje	pje
pjf	pjf
pjg	pjg
pjh	pjh
pji	pji
pjj	pjj
pjk	pjk
pjl	pjl
pjm	pjm
pjn	pjn
pjo	pjo
pjp	pjp
pjq	pjq
pjr	pjr
pjs	pjs
pjt	pjt
pju	pju
pjv	pjv
pjw	pjw
pjx	pjx
pjy	pjy
pjz	pjz
pka	pka
pkb	pkb
pkc	pkc
pkd	pkd
pke	pke
pkf	pkf
pkg	pkg
pkh	pkh
pki	pki
pkj	pkj
pkk	pkk
pkl	pkl
pkm	pkm
pkn	pkn
pko	pko
pkp	pkp
pkq	pkq
pkr	pkr
pks	pks
pkt	pkt
pku	pku
pkv	pkv
pkw	pkw
pkx	pkx
pky	pky
pkz	pkz
pla	pla
plb	plb
plc	plc
pld	pld
ple	ple
plf	plf
plg	plg
plh	plh
pli	pli
plj	plj
plk	plk
pll	pll
plm	plm
pln	pln
plo	plo
plp	plp
plq	plq
plr	plr
pls	pls
plt	plt
plu	plu
plv	plv
plw	plw
plx	plx
ply	ply
plz	plz
pma	pma
pmb	pmb
pmc	pmc
pmd	pmd
pme	pme
pmf	pmf
pmg	pmg
pmh	pmh
pmi	pmi
pmj	pmj
pmk	pmk
pml	pml
pmm	pmm
pmn	pmn
pmo	pmo
pmp	pmp
pmq	pmq
pmr	pmr
pms	pms
pmt	pmt
pmu	pmu
pmv	pmv
pmw	pmw
pmx	pmx
pmy	pmy
pmz	pmz
pna	pna
pnb	pnb
pnc	pnc
pnd	pnd
pne	pne
pnf	pnf
png	png
pnh	pnh
pni	pni
pnj	pnj
pnk	pnk
pnl	pnl
pnm	pnm
pnn	pnn
pno	pno
pnp	pnp
pnq	pnq
pnr	pnr
pns	pns
pnt	pnt
pnu	pnu
pnv	pnv
pnw	pnw
pnx	pnx
pny	pny
pnz	pnz
poa	poa
pob	pob
poc	poc
pod	pod
poe	poe
pof	pof
pog	pog
poh	poh
poi	poi
poj	poj
pok	pok
pol	pol
pom	pom
pon	pon
poo	poo
pop	pop
poq	poq
por	por
pos	pos
pot	pot
pou	pou
pov	pov
pow	pow
pox	pox
poy	poy
poz	poz
ppa	ppa
ppb	ppb
ppc	ppc
ppd	ppd
ppe	ppe
ppf	ppf
ppg	ppg
pph	pph
ppi	ppi
ppj	ppj
ppk	ppk
ppl	ppl
ppm	ppm
ppn	ppn
ppo	ppo
ppp	ppp
ppq	ppq
ppr	ppr
pps	pps
ppt	ppt
ppu	ppu
ppv	ppv
ppw	ppw
ppx	ppx
ppy	ppy
ppz	ppz
pqa	pqa
pqb	pqb
pqc	pqc
pqd	pqd
pqe	pqe
pqf	pqf
pqg	pqg
pqh	pqh
pqi	pqi
pqj	pqj
pqk	pqk
pql	pql
pqm	pqm
pqn	pqn
pqo	pqo
pqp	pqp
pqq	pqq
pqr	pqr
pqs	pqs
pqt	pqt
pqu	pqu
pqv	pqv
pqw	pqw
pqx	pqx
pqy	pqy
pqz	pqz
pra	pra
prb	prb
prc	prc
prd	prd
pre	pre
prf	prf
prg	prg
prh	prh
pri	pri
prj	prj
prk	prk
prl	prl
prm	prm
prn	prn
pro	pro
prp	prp
prq	prq
prr	prr
prs	prs
prt	prt
pru	pru
prv	prv
prw	prw
prx	prx
pry	pry
prz	prz
psa	psa
psb	psb
psc	psc
psd	psd
pse	pse
psf	psf
psg	psg
psh	psh
psi	psi
psj	psj
psk	psk
psl	psl
psm	psm
psn	psn
pso	pso
psp	psp
psq	psq
psr	psr
pss	pss
pst	pst
psu	psu
psv	psv
psw	psw
psx	psx
psy	psy
psz	psz
pta	pta
ptb	ptb
ptc	ptc
ptd	ptd
pte	pte
ptf	ptf
ptg	ptg
pth	pth
pti	pti
ptj	ptj
ptk	ptk
ptl	ptl
ptm	ptm
ptn	ptn
pto	pto
ptp	ptp
ptq	ptq
ptr	ptr
pts	pts
ptt	ptt
ptu	ptu
ptv	ptv
ptw	ptw
ptx	ptx
pty	pty
ptz	ptz
pua	pua
pub	pub
puc	puc
pud	pud
pue	pue
puf	puf
pug	pug
puh	puh
pui	pui
puj	puj
puk	puk
pul	pul
pum	pum
pun	pun
puo	puo
pup	pup
puq	puq
pur	pur
pus	pus
put	put
puu	puu
puv	puv
puw	puw
pux	pux
puy	puy
puz	puz
pva	pva
pvb	pvb
pvc	pvc
pvd	pvd
pve	pve
pvf	pvf
pvg	pvg
pvh	pvh
pvi	pvi
pvj	pvj
pvk	pvk
pvl	pvl
pvm	pvm
pvn	pvn
pvo	pvo
pvp	pvp
pvq	pvq
pvr	pvr
pvs	pvs
pvt	pvt
pvu	pvu
pvv	pvv
pvw	pvw
pvx	pvx
pvy	pvy
pvz	pvz
pwa	pwa
pwb	pwb
pwc	pwc
pwd	pwd
pwe	pwe
pwf	pwf
pwg	pwg
pwh	pwh
pwi	pwi
pwj	pwj
pwk	pwk
pwl	pwl
pwm	pwm
pwn	pwn
pwo	pwo
pwp	pwp
pwq	pwq
pwr	pwr
pws	pws
pwt	pwt
pwu	pwu
pwv	pwv
pww	pww
pwx	pwx
pwy	pwy
pwz	pwz
pxa	pxa
pxb	pxb
pxc	pxc
pxd	pxd
pxe	pxe
pxf	pxf
pxg	pxg
pxh	pxh
pxi	pxi
pxj	pxj
pxk	pxk
pxl	pxl
pxm	pxm
pxn	pxn
pxo	pxo
pxp	pxp
pxq	pxq
pxr	pxr
pxs	pxs
pxt	pxt
pxu	pxu
pxv	pxv
pxw	pxw
pxx	pxx
pxy	pxy
pxz	pxz
pya	pya
pyb	pyb
pyc	pyc
pyd	pyd
pye	pye
pyf	pyf
pyg	pyg
pyh	pyh
pyi	pyi
pyj	pyj
pyk	pyk
pyl	pyl
pym	pym
pyn	pyn
pyo	pyo
pyp	pyp
pyq	pyq
pyr	pyr
pys	pys
pyt	pyt
pyu	pyu
pyv	pyv
pyw	pyw
pyx	pyx
pyy	pyy
pyz	pyz
pza	pza
pzb	pzb
pzc	pzc
pzd	pzd
pze	pze
pzf	pzf
pzg	pzg
pzh	pzh
pzi	pzi
pzj	pzj
pzk	pzk
pzl	pzl
pzm	pzm
pzn	pzn
pzo	pzo
pzp	pzp
pzq	pzq
pzr	pzr
pzs	pzs
pzt	pzt
pzu	pzu
pzv	pzv
pzw	pzw
pzx	pzx
pzy	pzy
pzz	pzz
qaa	qaa
qab	qab
qac	qac
qad	qad
qae	qae
qaf	qaf
qag	qag
qah	qah
qai	qai
qaj	qaj
qak	qak
qal	qal
qam	qam
qan	qan
qao	qao
qap	qap
qaq	qaq
qar	qar
qas	qas
qat	qat
qau	qau
qav	qav
qaw	qaw
qax	qax
qay	qay
qaz	qaz
qba	qba
qbb	qbb
qbc	qbc
qbd	qbd
qbe	qbe
qbf	qbf
qbg	qbg
qbh	qbh
qbi	qbi
qbj	qbj
qbk	qbk
qbl	qbl
qbm	qbm
qbn	qbn
qbo	qbo
qbp	qbp
qbq	qbq
qbr	qbr
qbs	qbs
qbt	qbt
qbu	qbu
qbv	qbv
qbw	qbw
qbx	qbx
qby	qby
qbz	qbz
qca	qca
qcb	qcb
qcc	qcc
qcd	qcd
qce	qce
qcf	qcf
qcg	qcg
qch	qch
qci	qci
qcj	qcj
qck	qck
qcl	qcl
qcm	qcm
qcn	qcn
qco	qco
qcp	qcp
qcq	qcq
qcr	qcr
qcs	qcs
qct	qct
qcu	qcu
qcv	qcv
qcw	qcw
qcx	qcx
qcy	qcy
qcz	qcz
qda	qda
qdb	qdb
qdc	qdc
qdd	qdd
qde	qde
qdf	qdf
qdg	qdg
qdh	qdh
qdi	qdi
qdj	qdj
qdk	qdk
qdl	qdl
qdm	qdm
qdn	qdn
qdo	qdo
qdp	qdp
qdq	qdq
qdr	qdr
qds	qds
qdt	qdt
qdu	qdu
qdv	qdv
qdw	qdw
qdx	qdx
qdy	qdy
qdz	qdz
qea	qea
qeb	qeb
qec	qec
qed	qed
qee	qee
qef	qef
qeg	qeg
qeh	qeh
qei	qei
qej	qej
qek	qek
qel	qel
qem	qem
qen	qen
qeo	qeo
qep	qep
qeq	qeq
qer	qer
qes	qes
qet	qet
qeu	qeu
qev	qev
qew	qew
qex	qex
qey	qey
qez	qez
qfa	qfa
qfb	qfb
qfc	qfc
qfd	qfd
qfe	qfe
qff	qff
qfg	qfg
qfh	qfh
qfi	qfi
qfj	qfj
qfk	qfk
qfl	qfl
qfm	qfm
qfn	qfn
qfo	qfo
qfp	qfp
qfq	qfq
qfr	qfr
qfs	qfs
qft	qft
qfu	qfu
qfv	qfv
qfw	qfw
qfx	qfx
qfy	qfy
qfz	qfz
qga	qga
qgb	qgb
qgc	qgc
qgd	qgd
qge	qge
qgf	qgf
qgg	qgg
qgh	qgh
qgi	qgi
qgj	qgj
qgk	qgk
qgl	qgl
qgm	qgm
qgn	qgn
qgo	qgo
qgp	qgp
qgq	qgq
qgr	qgr
qgs	qgs
qgt	qgt
qgu	qgu
qgv	qgv
qgw	qgw
qgx	qgx
qgy	qgy
qgz	qgz
qha	qha
qhb	qhb
qhc	qhc
qhd	qhd
qhe	qhe
qhf	qhf
qhg	qhg
qhh	qhh
qhi	qhi
qhj	qhj
qhk	qhk
qhl	qhl
qhm	qhm
qhn	qhn
qho	qho
qhp	qhp
qhq	qhq
qhr	qhr
qhs	qhs
qht	qht
qhu	qhu
qhv	qhv
qhw	qhw
qhx	qhx
qhy	qhy
qhz	qhz
qia	qia
qib	qib
qic	qic
qid	qid
qie	qie
qif	qif
qig	qig
qih	qih
qii	qii
qij	qij
qik	qik
qil	qil
qim	qim
qin	qin
qio	qio
qip	qip
qiq	qiq
qir	qir
qis	qis
qit	qit
qiu	qiu
qiv	qiv
qiw	qiw
qix	qix
qiy	qiy
qiz	qiz
qja	qja
qjb	qjb
qjc	qjc
qjd	qjd
qje	qje
qjf	qjf
qjg	qjg
qjh	qjh
qji	qji
qjj	qjj
qjk	qjk
qjl	qjl
qjm	qjm
qjn	qjn
qjo	qjo
qjp	qjp
qjq	qjq
qjr	qjr
qjs	qjs
qjt	qjt
qju	qju
qjv	qjv
qjw	qjw
qjx	qjx
qjy	qjy
qjz	qjz
qka	qka
qkb	qkb
qkc	qkc
qkd	qkd
qke	qke
qkf	qkf
qkg	qkg
qkh	qkh
qki	qki
qkj	qkj
qkk	qkk
qkl	qkl
qkm	qkm
qkn	qkn
qko	qko
qkp	qkp
qkq	qkq
qkr	qkr
qks	qks
qkt	qkt
qku	qku
qkv	qkv
qkw	qkw
qkx	qkx
qky	qky
qkz	qkz
qla	qla
qlb	qlb
qlc	qlc
qld	qld
qle	qle
qlf	qlf
qlg	qlg
qlh	qlh
qli	qli
qlj	qlj
qlk	qlk
qll	qll
qlm	qlm
qln	qln
qlo	qlo
qlp	qlp
qlq	qlq
qlr	qlr
qls	qls
qlt	qlt
qlu	qlu
qlv	qlv
qlw	qlw
qlx	qlx
qly	qly
qlz	qlz
qma	qma
qmb	qmb
qmc	qmc
qmd	qmd
qme	qme
qmf	qmf
qmg	qmg
qmh	qmh
qmi	qmi
qmj	qmj
qmk	qmk
qml	qml
qmm	qmm
qmn	qmn
qmo	qmo
qmp	qmp
qmq	qmq
qmr	qmr
qms	qms
qmt	qmt
qmu	qmu
qmv	qmv
qmw	qmw
qmx	qmx
qmy	qmy
qmz	qmz
qna	qna
qnb	qnb
qnc	qnc
qnd	qnd
qne	qne
qnf	qnf
qng	qng
qnh	qnh
qni	qni
qnj	qnj
qnk	qnk
qnl	qnl
qnm	qnm
qnn	qnn
qno	qno
qnp	qnp
qnq	qnq
qnr	qnr
qns	qns
qnt	qnt
qnu	qnu
qnv	qnv
qnw	qnw
qnx	qnx
qny	qny
qnz	qnz
qoa	qoa
qob	qob
qoc	qoc
qod	qod
qoe	qoe
qof	qof
qog	qog
qoh	qoh
qoi	qoi
qoj	qoj
qok	qok
qol	qol
qom	qom
qon	qon
qoo	qoo
qop	qop
qoq	qoq
qor	qor
qos	qos
qot	qot
qou	qou
qov	qov
qow	qow
qox	qox
qoy	qoy
qoz	qoz
qpa	qpa
qpb	qpb
qpc	qpc
qpd	qpd
qpe	qpe
qpf	qpf
qpg	qpg
qph	qph
qpi	qpi
qpj	qpj
qpk	qpk
qpl	qpl
qpm	qpm
qpn	qpn
qpo	qpo
qpp	qpp
qpq	qpq
qpr	qpr
qps	qps
qpt	qpt
qpu	qpu
qpv	qpv
qpw	qpw
qpx	qpx
qpy	qpy
qpz	qpz
qqa	qqa
qqb	qqb
qqc	qqc
qqd	qqd
qqe	qqe
qqf	qqf
qqg	qqg
qqh	qqh
qqi	qqi
qqj	qqj
qqk	qqk
qql	qql
qqm	qqm
qqn	qqn
qqo	qqo
qqp	qqp
qqq	qqq
qqr	qqr
qqs	qqs
qqt	qqt
qqu	qqu
qqv	qqv
qqw	qqw
qqx	qqx
qqy	qqy
qqz	qqz
qra	qra
qrb	qrb
qrc	qrc
qrd	qrd
qre	qre
qrf	qrf
qrg	qrg
qrh	qrh
qri	qri
qrj	qrj
qrk	qrk
qrl	qrl
qrm	qrm
qrn	qrn
qro	qro
qrp	qrp
qrq	qrq
qrr	qrr
qrs	qrs
qrt	qrt
qru	qru
qrv	qrv
qrw	qrw
qrx	qrx
qry	qry
qrz	qrz
qsa	qsa
qsb	qsb
qsc	qsc
qsd	qsd
qse	qse
qsf	qsf
qsg	qsg
qsh	qsh
qsi	qsi
qsj	qsj
qsk	qsk
qsl	qsl
qsm	qsm
qsn	qsn
qso	qso
qsp	qsp
qsq	qsq
qsr	qsr
qss	qss
qst	qst
qsu	qsu
qsv	qsv
qsw	qsw
qsx	qsx
qsy	qsy
qsz	qsz
qta	qta
qtb	qtb
qtc	qtc
qtd	qtd
qte	qte
qtf	qtf
qtg	qtg
qth	qth
qti	qti
qtj	qtj
qtk	qtk
qtl	qtl
qtm	qtm
qtn	qtn
qto	qto
qtp	qtp
qtq	qtq
qtr	qtr
qts	qts
qtt	qtt
qtu	qtu
qtv	qtv
qtw	qtw
qtx	qtx
qty	qty
qtz	qtz
qua	qua
qub	qub
quc	quc
qud	qud
que	que
quf	quf
qug	qug
quh	quh
qui	qui
quj	quj
quk	quk
qul	qul
qum	qum
qun	qun
quo	quo
qup	qup
quq	quq
qur	qur
qus	qus
qut	qut
quu	quu
quv	quv
quw	quw
qux	qux
quy	quy
quz	quz
qva	qva
qvb	qvb
qvc	qvc
qvd	qvd
qve	qve
qvf	qvf
qvg	qvg
qvh	qvh
qvi	qvi
qvj	qvj
qvk	qvk
qvl	qvl
qvm	qvm
qvn	qvn
qvo	qvo
qvp	qvp
qvq	qvq
qvr	qvr
qvs	qvs
qvt	qvt
qvu	qvu
qvv	qvv
qvw	qvw
qvx	qvx
qvy	qvy
qvz	qvz
qwa	qwa
qwb	qwb
qwc	qwc
qwd	qwd
qwe	qwe
qwf	qwf
qwg	qwg
qwh	qwh
qwi	qwi
qwj	qwj
qwk	qwk
qwl	qwl
qwm	qwm
qwn	qwn
qwo	qwo
qwp	qwp
qwq	qwq
qwr	qwr
qws	qws
qwt	qwt
qwu	qwu
qwv	qwv
qww	qww
qwx	qwx
qwy	qwy
qwz	qwz
qxa	qxa
qxb	qxb
qxc	qxc
qxd	qxd
qxe	qxe
qxf	qxf
qxg	qxg
qxh	qxh
qxi	qxi
qxj	qxj
qxk	qxk
qxl	qxl
qxm	qxm
qxn	qxn
qxo	qxo
qxp	qxp
qxq	qxq
qxr	qxr
qxs	qxs
qxt	qxt
qxu	qxu
qxv	qxv
qxw	qxw
qxx	qxx
qxy	qxy
qxz	qxz
qya	qya
qyb	qyb
qyc	qyc
qyd	qyd
qye	qye
qyf	qyf
qyg	qyg
qyh	qyh
qyi	qyi
qyj	qyj
qyk	qyk
qyl	qyl
qym	qym
qyn	qyn
qyo	qyo
qyp	qyp
qyq	qyq
qyr	qyr
qys	qys
qyt	qyt
qyu	qyu
qyv	qyv
qyw	qyw
qyx	qyx
qyy	qyy
qyz	qyz
qza	qza
qzb	qzb
qzc	qzc
qzd	qzd
qze	qze
qzf	qzf
qzg	qzg
qzh	qzh
qzi	qzi
qzj	qzj
qzk	qzk
qzl	qzl
qzm	qzm
qzn	qzn
qzo	qzo
qzp	qzp
qzq	qzq
qzr	qzr
qzs	qzs
qzt	qzt
qzu	qzu
qzv	qzv
qzw	qzw
qzx	qzx
qzy	qzy
qzz	qzz
raa	raa
rab	rab
rac	rac
rad	rad
rae	rae
raf	raf
rag	rag
rah	rah
rai	rai
raj	raj
rak	rak
ral	ral
ram	ram
ran	ran
rao	rao
rap	rap
raq	raq
rar	rar
ras	ras
rat	rat
rau	rau
rav	rav
raw	raw
rax	rax
ray	ray
raz	raz
rba	rba
rbb	rbb
rbc	rbc
rbd	rbd
rbe	rbe
rbf	rbf
rbg	rbg
rbh	rbh
rbi	rbi
rbj	rbj
rbk	rbk
rbl	rbl
rbm	rbm
rbn	rbn
rbo	rbo
rbp	rbp
rbq	rbq
rbr	rbr
rbs	rbs
rbt	rbt
rbu	rbu
rbv	rbv
rbw	rbw
rbx	rbx
rby	rby
rbz	rbz
rca	rca
rcb	rcb
rcc	rcc
rcd	rcd
rce	rce
rcf	rcf
rcg	rcg
rch	rch
rci	rci
rcj	rcj
rck	rck
rcl	rcl
rcm	rcm
rcn	rcn
rco	rco
rcp	rcp
rcq	rcq
rcr	rcr
rcs	rcs
rct	rct
rcu	rcu
rcv	rcv
rcw	rcw
rcx	rcx
rcy	rcy
rcz	rcz
rda	rda
rdb	rdb
rdc	rdc
rdd	rdd
rde	rde
rdf	rdf
rdg	rdg
rdh	rdh
rdi	rdi
rdj	rdj
rdk	rdk
rdl	rdl
rdm	rdm
rdn	rdn
rdo	rdo
rdp	rdp
rdq	rdq
rdr	rdr
rds	rds
rdt	rdt
rdu	rdu
rdv	rdv
rdw	rdw
rdx	rdx
rdy	rdy
rdz	rdz
rea	rea
reb	reb
rec	rec
red	red
ree	ree
ref	ref
reg	reg
reh	reh
rei	rei
rej	rej
rek	rek
rel	rel
rem	rem
ren	ren
reo	reo
rep	rep
req	req
rer	rer
res	res
ret	ret
reu	reu
rev	rev
rew	rew
rex	rex
rey	rey
rez	rez
rfa	rfa
rfb	rfb
rfc	rfc
rfd	rfd
rfe	rfe
rff	rff
rfg	rfg
rfh	rfh
rfi	rfi
rfj	rfj
rfk	rfk
rfl	rfl
rfm	rfm
rfn	rfn
rfo	rfo
rfp	rfp
rfq	rfq
rfr	rfr
rfs	rfs
rft	rft
rfu	rfu
rfv	rfv
rfw	rfw
rfx	rfx
rfy	rfy
rfz	rfz
rga	rga
rgb	rgb
rgc	rgc
rgd	rgd
rge	rge
rgf	rgf
rgg	rgg
rgh	rgh
rgi	rgi
rgj	rgj
rgk	rgk
rgl	rgl
rgm	rgm
rgn	rgn
rgo	rgo
rgp	rgp
rgq	rgq
rgr	rgr
rgs	rgs
rgt	rgt
rgu	rgu
rgv	rgv
rgw	rgw
rgx	rgx
rgy	rgy
rgz	rgz
rha	rha
rhb	rhb
rhc	rhc
rhd	rhd
rhe	rhe
rhf	rhf
rhg	rhg
rhh	rhh
rhi	rhi
rhj	rhj
rhk	rhk
rhl	rhl
rhm	rhm
rhn	rhn
rho	rho
rhp	rhp
rhq	rhq
rhr	rhr
rhs	rhs
rht	rht
rhu	rhu
rhv	rhv
rhw	rhw
rhx	rhx
rhy	rhy
rhz	rhz
ria	ria
rib	rib
ric	ric
rid	rid
rie	rie
rif	rif
rig	rig
rih	rih
rii	rii
rij	rij
rik	rik
ril	ril
rim	rim
rin	rin
rio	rio
rip	rip
riq	riq
rir	rir
ris	ris
rit	rit
riu	riu
riv	riv
riw	riw
rix	rix
riy	riy
riz	riz
rja	rja
rjb	rjb
rjc	rjc
rjd	rjd
rje	rje
rjf	rjf
rjg	rjg
rjh	rjh
rji	rji
rjj	rjj
rjk	rjk
rjl	rjl
rjm	rjm
rjn	rjn
rjo	rjo
rjp	rjp
rjq	rjq
rjr	rjr
rjs	rjs
rjt	rjt
rju	rju
rjv	rjv
rjw	rjw
rjx	rjx
rjy	rjy
rjz	rjz
rka	rka
rkb	rkb
rkc	rkc
rkd	rkd
rke	rke
rkf	rkf
rkg	rkg
rkh	rkh
rki	rki
rkj	rkj
rkk	rkk
rkl	rkl
rkm	rkm
rkn	rkn
rko	rko
rkp	rkp
rkq	rkq
rkr	rkr
rks	rks
rkt	rkt
rku	rku
rkv	rkv
rkw	rkw
rkx	rkx
rky	rky
rkz	rkz
rla	rla
rlb	rlb
rlc	rlc
rld	rld
rle	rle
rlf	rlf
rlg	rlg
rlh	rlh
rli	rli
rlj	rlj
rlk	rlk
rll	rll
rlm	rlm
rln	rln
rlo	rlo
rlp	rlp
rlq	rlq
rlr	rlr
rls	rls
rlt	rlt
rlu	rlu
rlv	rlv
rlw	rlw
rlx	rlx
rly	rly
rlz	rlz
rma	rma
rmb	rmb
rmc	rmc
rmd	rmd
rme	rme
rmf	rmf
rmg	rmg
rmh	rmh
rmi	rmi
rmj	rmj
rmk	rmk
rml	rml
rmm	rmm
rmn	rmn
rmo	rmo
rmp	rmp
rmq	rmq
rmr	rmr
rms	rms
rmt	rmt
rmu	rmu
rmv	rmv
rmw	rmw
rmx	rmx
rmy	rmy
rmz	rmz
rna	rna
rnb	rnb
rnc	rnc
rnd	rnd
rne	rne
rnf	rnf
rng	rng
rnh	rnh
rni	rni
rnj	rnj
rnk	rnk
rnl	rnl
rnm	rnm
rnn	rnn
rno	rno
rnp	rnp
rnq	rnq
rnr	rnr
rns	rns
rnt	rnt
rnu	rnu
rnv	rnv
rnw	rnw
rnx	rnx
rny	rny
rnz	rnz
roa	roa
rob	rob
roc	roc
rod	rod
roe	roe
rof	rof
rog	rog
roh	roh
roi	roi
roj	roj
rok	rok
rol	rol
rom	rom
ron	ron
roo	roo
rop	rop
roq	roq
ror	ror
ros	ros
rot	rot
rou	rou
rov	rov
row	row
rox	rox
roy	roy
roz	roz
rpa	rpa
rpb	rpb
rpc	rpc
rpd	rpd
rpe	rpe
rpf	rpf
rpg	rpg
rph	rph
rpi	rpi
rpj	rpj
rpk	rpk
rpl	rpl
rpm	rpm
rpn	rpn
rpo	rpo
rpp	rpp
rpq	rpq
rpr	rpr
rps	rps
rpt	rpt
rpu	rpu
rpv	rpv
rpw	rpw
rpx	rpx
rpy	rpy
rpz	rpz
rqa	rqa
rqb	rqb
rqc	rqc
rqd	rqd
rqe	rqe
rqf	rqf
rqg	rqg
rqh	rqh
rqi	rqi
rqj	rqj
rqk	rqk
rql	rql
rqm	rqm
rqn	rqn
rqo	rqo
rqp	rqp
rqq	rqq
rqr	rqr
rqs	rqs
rqt	rqt
rqu	rqu
rqv	rqv
rqw	rqw
rqx	rqx
rqy	rqy
rqz	rqz
rra	rra
rrb	rrb
rrc	rrc
rrd	rrd
rre	rre
rrf	rrf
rrg	rrg
rrh	rrh
rri	rri
rrj	rrj
rrk	rrk
rrl	rrl
rrm	rrm
rrn	rrn
rro	rro
rrp	rrp
rrq	rrq
rrr	rrr
rrs	rrs
rrt	rrt
rru	rru
rrv	rrv
rrw	rrw
rrx	rrx
rry	rry
rrz	rrz
rsa	rsa
rsb	rsb
rsc	rsc
rsd	rsd
rse	rse
rsf	rsf
rsg	rsg
rsh	rsh
rsi	rsi
rsj	rsj
rsk	rsk
rsl	rsl
rsm	rsm
rsn	rsn
rso	rso
rsp	rsp
rsq	rsq
rsr	rsr
rss	rss
rst	rst
rsu	rsu
rsv	rsv
rsw	rsw
rsx	rsx
rsy	rsy
rsz	rsz
rta	rta
rtb	rtb
rtc	rtc
rtd	rtd
rte	rte
rtf	rtf
rtg	rtg
rth	rth
rti	rti
rtj	rtj
rtk	rtk
rtl	rtl
rtm	rtm
rtn	rtn
rto	rto
rtp	rtp
rtq	rtq
rtr	rtr
rts	rts
rtt	rtt
rtu	rtu
rtv	rtv
rtw	rtw
rtx	rtx
rty	rty
rtz	rtz
rua	rua
rub	rub
ruc	ruc
rud	rud
rue	rue
ruf	ruf
rug	rug
ruh	ruh
rui	rui
ruj	ruj
ruk	ruk
rul	rul
rum	rum
run	run
ruo	ruo
rup	rup
ruq	ruq
rur	rur
rus	rus
rut	rut
ruu	ruu
ruv	ruv
ruw	ruw
rux	rux
ruy	ruy
ruz	ruz
rva	rva
rvb	rvb
rvc	rvc
rvd	rvd
rve	rve
rvf	rvf
rvg	rvg
rvh	rvh
rvi	rvi
rvj	rvj
rvk	rvk
rvl	rvl
rvm	rvm
rvn	rvn
rvo	rvo
rvp	rvp
rvq	rvq
rvr	rvr
rvs	rvs
rvt	rvt
rvu	rvu
rvv	rvv
rvw	rvw
rvx	rvx
rvy	rvy
rvz	rvz
rwa	rwa
rwb	rwb
rwc	rwc
rwd	rwd
rwe	rwe
rwf	rwf
rwg	rwg
rwh	rwh
rwi	rwi
rwj	rwj
rwk	rwk
rwl	rwl
rwm	rwm
rwn	rwn
rwo	rwo
rwp	rwp
rwq	rwq
rwr	rwr
rws	rws
rwt	rwt
rwu	rwu
rwv	rwv
rww	rww
rwx	rwx
rwy	rwy
rwz	rwz
rxa	rxa
rxb	rxb
rxc	rxc
rxd	rxd
rxe	rxe
rxf	rxf
rxg	rxg
rxh	rxh
rxi	rxi
rxj	rxj
rxk	rxk
rxl	rxl
rxm	rxm
rxn	rxn
rxo	rxo
rxp	rxp
rxq	rxq
rxr	rxr
rxs	rxs
rxt	rxt
rxu	rxu
rxv	rxv
rxw	rxw
rxx	rxx
rxy	rxy
rxz	rxz
rya	rya
ryb	ryb
ryc	ryc
ryd	ryd
rye	rye
ryf	ryf
ryg	ryg
ryh	ryh
ryi	ryi
ryj	ryj
ryk	ryk
ryl	ryl
rym	rym
ryn	ryn
ryo	ryo
ryp	ryp
ryq	ryq
ryr	ryr
rys	rys
ryt	ryt
ryu	ryu
ryv	ryv
ryw	ryw
ryx	ryx
ryy	ryy
ryz	ryz
rza	rza
rzb	rzb
rzc	rzc
rzd	rzd
rze	rze
rzf	rzf
rzg	rzg
rzh	rzh
rzi	rzi
rzj	rzj
rzk	rzk
rzl	rzl
rzm	rzm
rzn	rzn
rzo	rzo
rzp	rzp
rzq	rzq
rzr	rzr
rzs	rzs
rzt	rzt
rzu	rzu
rzv	rzv
rzw	rzw
rzx	rzx
rzy	rzy
rzz	rzz
saa	saa
sab	sab
sac	sac
sad	sad
sae	sae
saf	saf
sag	sag
sah	sah
sai	sai
saj	saj
sak	sak
sal	sal
sam	sam
san	san
sao	sao
sap	sap
saq	saq
sar	sar
sas	sas
sat	sat
sau	sau
sav	sav
saw	saw
sax	sax
say	say
saz	saz
sba	sba
sbb	sbb
sbc	sbc
sbd	sbd
sbe	sbe
sbf	sbf
sbg	sbg
sbh	sbh
sbi	sbi
sbj	sbj
sbk	sbk
sbl	sbl
sbm	sbm
sbn	sbn
sbo	sbo
sbp	sbp
sbq	sbq
sbr	sbr
sbs	sbs
sbt	sbt
sbu	sbu
sbv	sbv
sbw	sbw
sbx	sbx
sby	sby
sbz	sbz
sca	sca
scb	scb
scc	scc
scd	scd
sce	sce
scf	scf
scg	scg
sch	sch
sci	sci
scj	scj
sck	sck
scl	scl
scm	scm
scn	scn
sco	sco
scp	scp
scq	scq
scr	scr
scs	scs
sct	sct
scu	scu
scv	scv
scw	scw
scx	scx
scy	scy
scz	scz
sda	sda
sdb	sdb
sdc	sdc
sdd	sdd
sde	sde
sdf	sdf
sdg	sdg
sdh	sdh
sdi	sdi
sdj	sdj
sdk	sdk
sdl	sdl
sdm	sdm
sdn	sdn
sdo	sdo
sdp	sdp
sdq	sdq
sdr	sdr
sds	sds
sdt	sdt
sdu	sdu
sdv	sdv
sdw	sdw
sdx	sdx
sdy	sdy
sdz	sdz
sea	sea
seb	seb
sec	sec
sed	sed
see	see
sef	sef
seg	seg
seh	seh
sei	sei
sej	sej
sek	sek
sel	sel
sem	sem
sen	sen
seo	seo
sep	sep
seq	seq
ser	ser
ses	ses
set	set
seu	seu
sev	sev
sew	sew
sex	sex
sey	sey
sez	sez
sfa	sfa
sfb	sfb
sfc	sfc
sfd	sfd
sfe	sfe
sff	sff
sfg	sfg
sfh	sfh
sfi	sfi
sfj	sfj
sfk	sfk
sfl	sfl
sfm	sfm
sfn	sfn
sfo	sfo
sfp	sfp
sfq	sfq
sfr	sfr
sfs	sfs
sft	sft
sfu	sfu
sfv	sfv
sfw	sfw
sfx	sfx
sfy	sfy
sfz	sfz
sga	sga
sgb	sgb
sgc	sgc
sgd	sgd
sge	sge
sgf	sgf
sgg	sgg
sgh	sgh
sgi	sgi
sgj	sgj
sgk	sgk
sgl	sgl
sgm	sgm
sgn	sgn
sgo	sgo
sgp	sgp
sgq	sgq
sgr	sgr
sgs	sgs
sgt	sgt
sgu	sgu
sgv	sgv
sgw	sgw
sgx	sgx
sgy	sgy
sgz	sgz
sha	sha
shb	shb
shc	shc
shd	shd
she	she
shf	shf
shg	shg
shh	shh
shi	shi
shj	shj
shk	shk
shl	shl
shm	shm
shn	shn
sho	sho
shp	shp
shq	shq
shr	shr
shs	shs
sht	sht
shu	shu
shv	shv
shw	shw
shx	shx
shy	shy
shz	shz
sia	sia
sib	sib
sic	sic
sid	sid
sie	sie
sif	sif
sig	sig
sih	sih
sii	sii
sij	sij
sik	sik
sil	sil
sim	sim
sin	sin
sio	sio
sip	sip
siq	siq
sir	sir
sis	sis
sit	sit
siu	siu
siv	siv
siw	siw
six	six
siy	siy
siz	siz
sja	sja
sjb	sjb
sjc	sjc
sjd	sjd
sje	sje
sjf	sjf
sjg	sjg
sjh	sjh
sji	sji
sjj	sjj
sjk	sjk
sjl	sjl
sjm	sjm
sjn	sjn
sjo	sjo
sjp	sjp
sjq	sjq
sjr	sjr
sjs	sjs
sjt	sjt
sju	sju
sjv	sjv
sjw	sjw
sjx	sjx
sjy	sjy
sjz	sjz
ska	ska
skb	skb
skc	skc
skd	skd
ske	ske
skf	skf
skg	skg
skh	skh
ski	ski
skj	skj
skk	skk
skl	skl
skm	skm
skn	skn
sko	sko
skp	skp
skq	skq
skr	skr
sks	sks
skt	skt
sku	sku
skv	skv
skw	skw
skx	skx
sky	sky
skz	skz
sla	sla
slb	slb
slc	slc
sld	sld
sle	sle
slf	slf
slg	slg
slh	slh
sli	sli
slj	slj
slk	slk
sll	sll
slm	slm
sln	sln
slo	slo
slp	slp
slq	slq
slr	slr
sls	sls
slt	slt
slu	slu
slv	slv
slw	slw
slx	slx
sly	sly
slz	slz
sma	sma
smb	smb
smc	smc
smd	smd
sme	sme
smf	smf
smg	smg
smh	smh
smi	smi
smj	smj
smk	smk
sml	sml
smm	smm
smn	smn
smo	smo
smp	smp
smq	smq
smr	smr
sms	sms
smt	smt
smu	smu
smv	smv
smw	smw
smx	smx
smy	smy
smz	smz
sna	sna
snb	snb
snc	snc
snd	snd
sne	sne
snf	snf
sng	sng
snh	snh
sni	sni
snj	snj
snk	snk
snl	snl
snm	snm
snn	snn
sno	sno
snp	snp
snq	snq
snr	snr
sns	sns
snt	snt
snu	snu
snv	snv
snw	snw
snx	snx
sny	sny
snz	snz
soa	soa
sob	sob
soc	soc
sod	sod
soe	soe
sof	sof
sog	sog
soh	soh
soi	soi
soj	soj
sok	sok
sol	sol
som	som
son	son
soo	soo
sop	sop
soq	soq
sor	sor
sos	sos
sot	sot
sou	sou
sov	sov
sow	sow
sox	sox
soy	soy
soz	soz
spa	spa
spb	spb
spc	spc
spd	spd
spe	spe
spf	spf
spg	spg
sph	sph
spi	spi
spj	spj
spk	spk
spl	spl
spm	spm
spn	spn
spo	spo
spp	spp
spq	spq
spr	spr
sps	sps
spt	spt
spu	spu
spv	spv
spw	spw
spx	spx
spy	spy
spz	spz
sqa	sqa
sqb	sqb
sqc	sqc
sqd	sqd
sqe	sqe
sqf	sqf
sqg	sqg
sqh	sqh
sqi	sqi
sqj	sqj
sqk	sqk
sql	sql
sqm	sqm
sqn	sqn
sqo	sqo
sqp	sqp
sqq	sqq
sqr	sqr
sqs	sqs
sqt	sqt
squ	squ
sqv	sqv
sqw	sqw
sqx	sqx
sqy	sqy
sqz	sqz
sra	sra
srb	srb
src	src
srd	srd
sre	sre
srf	srf
srg	srg
srh	srh
sri	sri
srj	srj
srk	srk
srl	srl
srm	srm
srn	srn
sro	sro
srp	srp
srq	srq
srr	srr
srs	srs
srt	srt
sru	sru
srv	srv
srw	srw
srx	srx
sry	sry
srz	srz
ssa	ssa
ssb	ssb
ssc	ssc
ssd	ssd
sse	sse
ssf	ssf
ssg	ssg
ssh	ssh
ssi	ssi
ssj	ssj
ssk	ssk
ssl	ssl
ssm	ssm
ssn	ssn
sso	sso
ssp	ssp
ssq	ssq
ssr	ssr
sss	sss
sst	sst
ssu	ssu
ssv	ssv
ssw	ssw
ssx	ssx
ssy	ssy
ssz	ssz
sta	sta
stb	stb
stc	stc
std	std
ste	ste
stf	stf
stg	stg
sth	sth
sti	sti
stj	stj
stk	stk
stl	stl
stm	stm
stn	stn
sto	sto
stp	stp
stq	stq
str	str
sts	sts
stt	stt
stu	stu
stv	stv
stw	stw
stx	stx
sty	sty
stz	stz
sua	sua
sub	sub
suc	suc
sud	sud
sue	sue
suf	suf
sug	sug
suh	suh
sui	sui
suj	suj
suk	suk
sul	sul
sum	sum
sun	sun
suo	suo
sup	sup
suq	suq
sur	sur
sus	sus
sut	sut
suu	suu
suv	suv
suw	suw
sux	sux
suy	suy
suz	suz
sva	sva
svb	svb
svc	svc
svd	svd
sve	sve
svf	svf
svg	svg
svh	svh
svi	svi
svj	svj
svk	svk
svl	svl
svm	svm
svn	svn
svo	svo
svp	svp
svq	svq
svr	svr
svs	svs
svt	svt
svu	svu
svv	svv
svw	svw
svx	svx
svy	svy
svz	svz
swa	swa
swb	swb
swc	swc
swd	swd
swe	swe
swf	swf
swg	swg
swh	swh
swi	swi
swj	swj
swk	swk
swl	swl
swm	swm
swn	swn
swo	swo
swp	swp
swq	swq
swr	swr
sws	sws
swt	swt
swu	swu
swv	swv
sww	sww
swx	swx
swy	swy
swz	swz
sxa	sxa
sxb	sxb
sxc	sxc
sxd	sxd
sxe	sxe
sxf	sxf
sxg	sxg
sxh	sxh
sxi	sxi
sxj	sxj
sxk	sxk
sxl	sxl
sxm	sxm
sxn	sxn
sxo	sxo
sxp	sxp
sxq	sxq
sxr	sxr
sxs	sxs
sxt	sxt
sxu	sxu
sxv	sxv
sxw	sxw
sxx	sxx
sxy	sxy
sxz	sxz
sya	sya
syb	syb
syc	syc
syd	syd
sye	sye
syf	syf
syg	syg
syh	syh
syi	syi
syj	syj
syk	syk
syl	syl
sym	sym
syn	syn
syo	syo
syp	syp
syq	syq
syr	syr
sys	sys
syt	syt
syu	syu
syv	syv
syw	syw
syx	syx
syy	syy
syz	syz
sza	sza
szb	szb
szc	szc
szd	szd
sze	sze
szf	szf
szg	szg
szh	szh
szi	szi
szj	szj
szk	szk
szl	szl
szm	szm
szn	szn
szo	szo
szp	szp
szq	szq
szr	szr
szs	szs
szt	szt
szu	szu
szv	szv
szw	szw
szx	szx
szy	szy
szz	szz
taa	taa
tab	tab
tac	tac
tad	tad
tae	tae
taf	taf
tag	tag
tah	tah
tai	tai
taj	taj
tak	tak
tal	tal
tam	tam
tan	tan
tao	tao
tap	tap
taq	taq
tar	tar
tas	tas
tat	tat
tau	tau
tav	tav
taw	taw
tax	tax
tay	tay
taz	taz
tba	tba
tbb	tbb
tbc	tbc
tbd	tbd
tbe	tbe
tbf	tbf
tbg	tbg
tbh	tbh
tbi	tbi
tbj	tbj
tbk	tbk
tbl	tbl
tbm	tbm
tbn	tbn
tbo	tbo
tbp	tbp
tbq	tbq
tbr	tbr
tbs	tbs
tbt	tbt
tbu	tbu
tbv	tbv
tbw	tbw
tbx	tbx
tby	tby
tbz	tbz
tca	tca
tcb	tcb
tcc	tcc
tcd	tcd
tce	tce
tcf	tcf
tcg	tcg
tch	tch
tci	tci
tcj	tcj
tck	tck
tcl	tcl
tcm	tcm
tcn	tcn
tco	tco
tcp	tcp
tcq	tcq
tcr	tcr
tcs	tcs
tct	tct
tcu	tcu
tcv	tcv
tcw	tcw
tcx	tcx
tcy	tcy
tcz	tcz
tda	tda
tdb	tdb
tdc	tdc
tdd	tdd
tde	tde
tdf	tdf
tdg	tdg
tdh	tdh
tdi	tdi
tdj	tdj
tdk	tdk
tdl	tdl
tdm	tdm
tdn	tdn
tdo	tdo
tdp	tdp
tdq	tdq
tdr	tdr
tds	tds
tdt	tdt
tdu	tdu
tdv	tdv
tdw	tdw
tdx	tdx
tdy	tdy
tdz	tdz
tea	tea
teb	teb
tec	tec
ted	ted
tee	tee
tef	tef
teg	teg
teh	teh
tei	tei
tej	tej
tek	tek
tel	tel
tem	tem
ten	ten
teo	teo
tep	tep
teq	teq
ter	ter
tes	tes
tet	tet
teu	teu
tev	tev
tew	tew
tex	tex
tey	tey
tez	tez
tfa	tfa
tfb	tfb
tfc	tfc
tfd	tfd
tfe	tfe
tff	tff
tfg	tfg
tfh	tfh
tfi	tfi
tfj	tfj
tfk	tfk
tfl	tfl
tfm	tfm
tfn	tfn
tfo	tfo
tfp	tfp
tfq	tfq
tfr	tfr
tfs	tfs
tft	tft
tfu	tfu
tfv	tfv
tfw	tfw
tfx	tfx
tfy	tfy
tfz	tfz
tga	tga
tgb	tgb
tgc	tgc
tgd	tgd
tge	tge
tgf	tgf
tgg	tgg
tgh	tgh
tgi	tgi
tgj	tgj
tgk	tgk
tgl	tgl
tgm	tgm
tgn	tgn
tgo	tgo
tgp	tgp
tgq	tgq
tgr	tgr
tgs	tgs
tgt	tgt
tgu	tgu
tgv	tgv
tgw	tgw
tgx	tgx
tgy	tgy
tgz	tgz
tha	tha
thb	thb
thc	thc
thd	thd
the	the
thf	thf
thg	thg
thh	thh
thi	thi
thj	thj
thk	thk
thl	thl
thm	thm
thn	thn
tho	tho
thp	thp
thq	thq
thr	thr
ths	ths
tht	tht
thu	thu
thv	thv
thw	thw
thx	thx
thy	thy
thz	thz
tia	tia
tib	tib
tic	tic
tid	tid
tie	tie
tif	tif
tig	tig
tih	tih
tii	tii
tij	tij
tik	tik
til	til
tim	tim
tin	tin
tio	tio
tip	tip
tiq	tiq
tir	tir
tis	tis
tit	tit
tiu	tiu
tiv	tiv
tiw	tiw
tix	tix
tiy	tiy
tiz	tiz
tja	tja
tjb	tjb
tjc	tjc
tjd	tjd
tje	tje
tjf	tjf
tjg	tjg
tjh	tjh
tji	tji
tjj	tjj
tjk	tjk
tjl	tjl
tjm	tjm
tjn	tjn
tjo	tjo
tjp	tjp
tjq	tjq
tjr	tjr
tjs	tjs
tjt	tjt
tju	tju
tjv	tjv
tjw	tjw
tjx	tjx
tjy	tjy
tjz	tjz
tka	tka
tkb	tkb
tkc	tkc
tkd	tkd
tke	tke
tkf	tkf
tkg	tkg
tkh	tkh
tki	tki
tkj	tkj
tkk	tkk
tkl	tkl
tkm	tkm
tkn	tkn
tko	tko
tkp	tkp
tkq	tkq
tkr	tkr
tks	tks
tkt	tkt
tku	tku
tkv	tkv
tkw	tkw
tkx	tkx
tky	tky
tkz	tkz
tla	tla
tlb	tlb
tlc	tlc
tld	tld
tle	tle
tlf	tlf
tlg	tlg
tlh	tlh
tli	tli
tlj	tlj
tlk	tlk
tll	tll
tlm	tlm
tln	tln
tlo	tlo
tlp	tlp
tlq	tlq
tlr	tlr
tls	tls
tlt	tlt
tlu	tlu
tlv	tlv
tlw	tlw
tlx	tlx
tly	tly
tlz	tlz
tma	tma
tmb	tmb
tmc	tmc
tmd	tmd
tme	tme
tmf	tmf
tmg	tmg
tmh	tmh
tmi	tmi
tmj	tmj
tmk	tmk
tml	tml
tmm	tmm
tmn	tmn
tmo	tmo
tmp	tmp
tmq	tmq
tmr	tmr
tms	tms
tmt	tmt
tmu	tmu
tmv	tmv
tmw	tmw
tmx	tmx
tmy	tmy
tmz	tmz
tna	tna
tnb	tnb
tnc	tnc
tnd	tnd
tne	tne
tnf	tnf
tng	tng
tnh	tnh
tni	tni
tnj	tnj
tnk	tnk
tnl	tnl
tnm	tnm
tnn	tnn
tno	tno
tnp	tnp
tnq	tnq
tnr	tnr
tns	tns
tnt	tnt
tnu	tnu
tnv	tnv
tnw	tnw
tnx	tnx
tny	tny
tnz	tnz
toa	toa
tob	tob
toc	toc
tod	tod
toe	toe
tof	tof
tog	tog
toh	toh
toi	toi
toj	toj
tok	tok
tol	tol
tom	tom
ton	ton
too	too
top	top
toq	toq
tor	tor
tos	tos
tot	tot
tou	tou
tov	tov
tow	tow
tox	tox
toy	toy
toz	toz
tpa	tpa
tpb	tpb
tpc	tpc
tpd	tpd
tpe	tpe
tpf	tpf
tpg	tpg
tph	tph
tpi	tpi
tpj	tpj
tpk	tpk
tpl	tpl
tpm	tpm
tpn	tpn
tpo	tpo
tpp	tpp
tpq	tpq
tpr	tpr
tps	tps
tpt	tpt
tpu	tpu
tpv	tpv
tpw	tpw
tpx	tpx
tpy	tpy
tpz	tpz
tqa	tqa
tqb	tqb
tqc	tqc
tqd	tqd
tqe	tqe
tqf	tqf
tqg	tqg
tqh	tqh
tqi	tqi
tqj	tqj
tqk	tqk
tql	tql
tqm	tqm
tqn	tqn
tqo	tqo
tqp	tqp
tqq	tqq
tqr	tqr
tqs	tqs
tqt	tqt
tqu	tqu
tqv	tqv
tqw	tqw
tqx	tqx
tqy	tqy
tqz	tqz
tra	tra
trb	trb
trc	trc
trd	trd
tre	tre
trf	trf
trg	trg
trh	trh
tri	tri
trj	trj
trk	trk
trl	trl
trm	trm
trn	trn
tro	tro
trp	trp
trq	trq
trr	trr
trs	trs
trt	trt
tru	tru
trv	trv
trw	trw
trx	trx
try	try
trz	trz
tsa	tsa
tsb	tsb
tsc	tsc
tsd	tsd
tse	tse
tsf	tsf
tsg	tsg
tsh	tsh
tsi	tsi
tsj	tsj
tsk	tsk
tsl	tsl
tsm	tsm
tsn	tsn
tso	tso
tsp	tsp
tsq	tsq
tsr	tsr
tss	tss
tst	tst
tsu	tsu
tsv	tsv
tsw	tsw
tsx	tsx
tsy	tsy
tsz	tsz
tta	tta
ttb	ttb
ttc	ttc
ttd	ttd
tte	tte
ttf	ttf
ttg	ttg
tth	tth
tti	tti
ttj	ttj
ttk	ttk
ttl	ttl
ttm	ttm
ttn	ttn
tto	tto
ttp	ttp
ttq	ttq
ttr	ttr
tts	tts
ttt	ttt
ttu	ttu
ttv	ttv
ttw	ttw
ttx	ttx
tty	tty
ttz	ttz
tua	tua
tub	tub
tuc	tuc
tud	tud
tue	tue
tuf	tuf
tug	tug
tuh	tuh
tui	tui
tuj	tuj
tuk	tuk
tul	tul
tum	tum
tun	tun
tuo	tuo
tup	tup
tuq	tuq
tur	tur
tus	tus
tut	tut
tuu	tuu
tuv	tuv
tuw	tuw
tux	tux
tuy	tuy
tuz	tuz
tva	tva
tvb	tvb
tvc	tvc
tvd	tvd
tve	tve
tvf	tvf
tvg	tvg
tvh	tvh
tvi	tvi
tvj	tvj
tvk	tvk
tvl	tvl
tvm	tvm
tvn	tvn
tvo	tvo
tvp	tvp
tvq	tvq
tvr	tvr
tvs	tvs
tvt	tvt
tvu	tvu
tvv	tvv
tvw	tvw
tvx	tvx
tvy	tvy
tvz	tvz
twa	twa
twb	twb
twc	twc
twd	twd
twe	twe
twf	twf
twg	twg
twh	twh
twi	twi
twj	twj
twk	twk
twl	twl
twm	twm
twn	twn
two	two
twp	twp
twq	twq
twr	twr
tws	tws
twt	twt
twu	twu
twv	twv
tww	tww
twx	twx
twy	twy
twz	twz
txa	txa
txb	txb
txc	txc
txd	txd
txe	txe
txf	txf
txg	txg
txh	txh
txi	txi
txj	txj
txk	txk
txl	txl
txm	txm
txn	txn
txo	txo
txp	txp
txq	txq
txr	txr
txs	txs
txt	txt
txu	txu
txv	txv
txw	txw
txx	txx
txy	txy
txz	txz
tya	tya
tyb	tyb
tyc	tyc
tyd	tyd
tye	tye
tyf	tyf
tyg	tyg
tyh	tyh
tyi	tyi
tyj	tyj
tyk	tyk
tyl	tyl
tym	tym
tyn	tyn
tyo	tyo
typ	typ
tyq	tyq
tyr	tyr
tys	tys
tyt	tyt
tyu	tyu
tyv	tyv
tyw	tyw
tyx	tyx
tyy	tyy
tyz	tyz
tza	tza
tzb	tzb
tzc	tzc
tzd	tzd
tze	tze
tzf	tzf
tzg	tzg
tzh	tzh
tzi	tzi
tzj	tzj
tzk	tzk
tzl	tzl
tzm	tzm
tzn	tzn
tzo	tzo
tzp	tzp
tzq	tzq
tzr	tzr
tzs	tzs
tzt	tzt
tzu	tzu
tzv	tzv
tzw	tzw
tzx	tzx
tzy	tzy
tzz	tzz
uaa	uaa
uab	uab
uac	uac
uad	uad
uae	uae
uaf	uaf
uag	uag
uah	uah
uai	uai
uaj	uaj
uak	uak
ual	ual
uam	uam
uan	uan
uao	uao
uap	uap
uaq	uaq
uar	uar
uas	uas
uat	uat
uau	uau
uav	uav
uaw	uaw
uax	uax
uay	uay
uaz	uaz
uba	uba
ubb	ubb
ubc	ubc
ubd	ubd
ube	ube
ubf	ubf
ubg	ubg
ubh	ubh
ubi	ubi
ubj	ubj
ubk	ubk
ubl	ubl
ubm	ubm
ubn	ubn
ubo	ubo
ubp	ubp
ubq	ubq
ubr	ubr
ubs	ubs
ubt	ubt
ubu	ubu
ubv	ubv
ubw	ubw
ubx	ubx
uby	uby
ubz	ubz
uca	uca
ucb	ucb
ucc	ucc
ucd	ucd
uce	uce
ucf	ucf
ucg	ucg
uch	uch
uci	uci
ucj	ucj
uck	uck
ucl	ucl
ucm	ucm
ucn	ucn
uco	uco
ucp	ucp
ucq	ucq
ucr	ucr
ucs	ucs
uct	uct
ucu	ucu
ucv	ucv
ucw	ucw
ucx	ucx
ucy	ucy
ucz	ucz
uda	uda
udb	udb
udc	udc
udd	udd
ude	ude
udf	udf
udg	udg
udh	udh
udi	udi
udj	udj
udk	udk
udl	udl
udm	udm
udn	udn
udo	udo
udp	udp
udq	udq
udr	udr
uds	uds
udt	udt
udu	udu
udv	udv
udw	udw
udx	udx
udy	udy
udz	udz
uea	uea
ueb	ueb
uec	uec
ued	ued
uee	uee
uef	uef
ueg	ueg
ueh	ueh
uei	uei
uej	uej
uek	uek
uel	uel
uem	uem
uen	uen
ueo	ueo
uep	uep
ueq	ueq
uer	uer
ues	ues
uet	uet
ueu	ueu
uev	uev
uew	uew
uex	uex
uey	uey
uez	uez
ufa	ufa
ufb	ufb
ufc	ufc
ufd	ufd
ufe	ufe
uff	uff
ufg	ufg
ufh	ufh
ufi	ufi
ufj	ufj
ufk	ufk
ufl	ufl
ufm	ufm
ufn	ufn
ufo	ufo
ufp	ufp
ufq	ufq
ufr	ufr
ufs	ufs
uft	uft
ufu	ufu
ufv	ufv
ufw	ufw
ufx	ufx
ufy	ufy
ufz	ufz
uga	uga
ugb	ugb
ugc	ugc
ugd	ugd
uge	uge
ugf	ugf
ugg	ugg
ugh	ugh
ugi	ugi
ugj	ugj
ugk	ugk
ugl	ugl
ugm	ugm
ugn	ugn
ugo	ugo
ugp	ugp
ugq	ugq
ugr	ugr
ugs	ugs
ugt	ugt
ugu	ugu
ugv	ugv
ugw	ugw
ugx	ugx
ugy	ugy
ugz	ugz
uha	uha
uhb	uhb
uhc	uhc
uhd	uhd
uhe	uhe
uhf	uhf
uhg	uhg
uhh	uhh
uhi	uhi
uhj	uhj
uhk	uhk
uhl	uhl
uhm	uhm
uhn	uhn
uho	uho
uhp	uhp
uhq	uhq
uhr	uhr
uhs	uhs
uht	uht
uhu	uhu
uhv	uhv
uhw	uhw
uhx	uhx
uhy	uhy
uhz	uhz
uia	uia
uib	uib
uic	uic
uid	uid
uie	uie
uif	uif
uig	uig
uih	uih
uii	uii
uij	uij
uik	uik
uil	uil
uim	uim
uin	uin
uio	uio
uip	uip
uiq	uiq
uir	uir
uis	uis
uit	uit
uiu	uiu
uiv	uiv
uiw	uiw
uix	uix
uiy	uiy
uiz	uiz
uja	uja
ujb	ujb
ujc	ujc
ujd	ujd
uje	uje
ujf	ujf
ujg	ujg
ujh	ujh
uji	uji
ujj	ujj
ujk	ujk
ujl	ujl
ujm	ujm
ujn	ujn
ujo	ujo
ujp	ujp
ujq	ujq
ujr	ujr
ujs	ujs
ujt	ujt
uju	uju
ujv	ujv
ujw	ujw
ujx	ujx
ujy	ujy
ujz	ujz
uka	uka
ukb	ukb
ukc	ukc
ukd	ukd
uke	uke
ukf	ukf
ukg	ukg
ukh	ukh
uki	uki
ukj	ukj
ukk	ukk
ukl	ukl
ukm	ukm
ukn	ukn
uko	uko
ukp	ukp
ukq	ukq
ukr	ukr
uks	uks
ukt	ukt
uku	uku
ukv	ukv
ukw	ukw
ukx	ukx
uky	uky
ukz	ukz
ula	ula
ulb	ulb
ulc	ulc
uld	uld
ule	ule
ulf	ulf
ulg	ulg
ulh	ulh
uli	uli
ulj	ulj
ulk	ulk
ull	ull
ulm	ulm
uln	uln
ulo	ulo
ulp	ulp
ulq	ulq
ulr	ulr
uls	uls
ult	ult
ulu	ulu
ulv	ulv
ulw	ulw
ulx	ulx
uly	uly
ulz	ulz
uma	uma
umb	umb
umc	umc
umd	umd
ume	ume
umf	umf
umg	umg
umh	umh
umi	umi
umj	umj
umk	umk
uml	uml
umm	umm
umn	umn
umo	umo
ump	ump
umq	umq
umr	umr
ums	ums
umt	umt
umu	umu
umv	umv
umw	umw
umx	umx
umy	umy
umz	umz
una	una
unb	unb
unc	unc
und	und
une	une
unf	unf
ung	ung
unh	unh
uni	uni
unj	unj
unk	unk
unl	unl
unm	unm
unn	unn
uno	uno
unp	unp
unq	unq
unr	unr
uns	uns
unt	unt
unu	unu
unv	unv
unw	unw
unx	unx
uny	uny
unz	unz
uoa	uoa
uob	uob
uoc	uoc
uod	uod
uoe	uoe
uof	uof
uog	uog
uoh	uoh
uoi	uoi
uoj	uoj
uok	uok
uol	uol
uom	uom
uon	uon
uoo	uoo
uop	uop
uoq	uoq
uor	uor
uos	uos
uot	uot
uou	uou
uov	uov
uow	uow
uox	uox
uoy	uoy
uoz	uoz
upa	upa
upb	upb
upc	upc
upd	upd
upe	upe
upf	upf
upg	upg
uph	uph
upi	upi
upj	upj
upk	upk
upl	upl
upm	upm
upn	upn
upo	upo
upp	upp
upq	upq
upr	upr
ups	ups
upt	upt
upu	upu
upv	upv
upw	upw
upx	upx
upy	upy
upz	upz
uqa	uqa
uqb	uqb
uqc	uqc
uqd	uqd
uqe	uqe
uqf	uqf
uqg	uqg
uqh	uqh
uqi	uqi
uqj	uqj
uqk	uqk
uql	uql
uqm	uqm
uqn	uqn
uqo	uqo
uqp	uqp
uqq	uqq
uqr	uqr
uqs	uqs
uqt	uqt
uqu	uqu
uqv	uqv
uqw	uqw
uqx	uqx
uqy	uqy
uqz	uqz
ura	ura
urb	urb
urc	urc
urd	urd
ure	ure
urf	urf
urg	urg
urh	urh
uri	uri
urj	urj
urk	urk
url	url
urm	urm
urn	urn
uro	uro
urp	urp
urq	urq
urr	urr
urs	urs
urt	urt
uru	uru
urv	urv
urw	urw
urx	urx
ury	ury
urz	urz
usa	usa
usb	usb
usc	usc
usd	usd
use	use
usf	usf
usg	usg
ush	ush
usi	usi
usj	usj
usk	usk
usl	usl
usm	usm
usn	usn
uso	uso
usp	usp
usq	usq
usr	usr
uss	uss
ust	ust
usu	usu
usv	usv
usw	usw
usx	usx
usy	usy
usz	usz
uta	uta
utb	utb
utc	utc
utd	utd
ute	ute
utf	utf
utg	utg
uth	uth
uti	uti
utj	utj
utk	utk
utl	utl
utm	utm
utn	utn
uto	uto
utp	utp
utq	utq
utr	utr
uts	uts
utt	utt
utu	utu
utv	utv
utw	utw
utx	utx
uty	uty
utz	utz
uua	uua
uub	uub
uuc	uuc
uud	uud
uue	uue
uuf	uuf
uug	uug
uuh	uuh
uui	uui
uuj	uuj
uuk	uuk
uul	uul
uum	uum
uun	uun
uuo	uuo
uup	uup
uuq	uuq
uur	uur
uus	uus
uut	uut
uuu	uuu
uuv	uuv
uuw	uuw
uux	uux
uuy	uuy
uuz	uuz
uva	uva
uvb	uvb
uvc	uvc
uvd	uvd
uve	uve
uvf	uvf
uvg	uvg
uvh	uvh
uvi	uvi
uvj	uvj
uvk	uvk
uvl	uvl
uvm	uvm
uvn	uvn
uvo	uvo
uvp	uvp
uvq	uvq
uvr	uvr
uvs	uvs
uvt	uvt
uvu	uvu
uvv	uvv
uvw	uvw
uvx	uvx
uvy	uvy
uvz	uvz
uwa	uwa
uwb	uwb
uwc	uwc
uwd	uwd
uwe	uwe
uwf	uwf
uwg	uwg
uwh	uwh
uwi	uwi
uwj	uwj
uwk	uwk
uwl	uwl
uwm	uwm
uwn	uwn
uwo	uwo
uwp	uwp
uwq	uwq
uwr	uwr
uws	uws
uwt	uwt
uwu	uwu
uwv	uwv
uww	uww
uwx	uwx
uwy	uwy
uwz	uwz
uxa	uxa
uxb	uxb
uxc	uxc
uxd	uxd
uxe	uxe
uxf	uxf
uxg	uxg
uxh	uxh
uxi	uxi
uxj	uxj
uxk	uxk
uxl	uxl
uxm	uxm
uxn	uxn
uxo	uxo
uxp	uxp
uxq	uxq
uxr	uxr
uxs	uxs
uxt	uxt
uxu	uxu
uxv	uxv
uxw	uxw
uxx	uxx
uxy	uxy
uxz	uxz
uya	uya
uyb	uyb
uyc	uyc
uyd	uyd
uye	uye
uyf	uyf
uyg	uyg
uyh	uyh
uyi	uyi
uyj	uyj
uyk	uyk
uyl	uyl
uym	uym
uyn	uyn
uyo	uyo
uyp	uyp
uyq	uyq
uyr	uyr
uys	uys
uyt	uyt
uyu	uyu
uyv	uyv
uyw	uyw
uyx	uyx
uyy	uyy
uyz	uyz
uza	uza
uzb	uzb
uzc	uzc
uzd	uzd
uze	uze
uzf	uzf
uzg	uzg
uzh	uzh
uzi	uzi
uzj	uzj
uzk	uzk
uzl	uzl
uzm	uzm
uzn	uzn
uzo	uzo
uzp	uzp
uzq	uzq
uzr	uzr
uzs	uzs
uzt	uzt
uzu	uzu
uzv	uzv
uzw	uzw
uzx	uzx
uzy	uzy
uzz	uzz
vaa	vaa
vab	vab
vac	vac
vad	vad
vae	vae
vaf	vaf
vag	vag
vah	vah
vai	vai
vaj	vaj
vak	vak
val	val
vam	vam
van	van
vao	vao
vap	vap
vaq	vaq
var	var
vas	vas
vat	vat
vau	vau
vav	vav
vaw	vaw
vax	vax
vay	vay
vaz	vaz
vba	vba
vbb	vbb
vbc	vbc
vbd	vbd
vbe	vbe
vbf	vbf
vbg	vbg
vbh	vbh
vbi	vbi
vbj	vbj
vbk	vbk
vbl	vbl
vbm	vbm
vbn	vbn
vbo	vbo
vbp	vbp
vbq	vbq
vbr	vbr
vbs	vbs
vbt	vbt
vbu	vbu
vbv	vbv
vbw	vbw
vbx	vbx
vby	vby
vbz	vbz
vca	vca
vcb	vcb
vcc	vcc
vcd	vcd
vce	vce
vcf	vcf
vcg	vcg
vch	vch
vci	vci
vcj	vcj
vck	vck
vcl	vcl
vcm	vcm
vcn	vcn
vco	vco
vcp	vcp
vcq	vcq
vcr	vcr
vcs	vcs
vct	vct
vcu	vcu
vcv	vcv
vcw	vcw
vcx	vcx
vcy	vcy
vcz	vcz
vda	vda
vdb	vdb
vdc	vdc
vdd	vdd
vde	vde
vdf	vdf
vdg	vdg
vdh	vdh
vdi	vdi
vdj	vdj
vdk	vdk
vdl	vdl
vdm	vdm
vdn	vdn
vdo	vdo
vdp	vdp
vdq	vdq
vdr	vdr
vds	vds
vdt	vdt
vdu	vdu
vdv	vdv
vdw	vdw
vdx	vdx
vdy	vdy
vdz	vdz
vea	vea
veb	veb
vec	vec
ved	ved
vee	vee
vef	vef
veg	veg
veh	veh
vei	vei
vej	vej
vek	vek
vel	vel
vem	vem
ven	ven
veo	veo
vep	vep
veq	veq
ver	ver
ves	ves
vet	vet
veu	veu
vev	vev
vew	vew
vex	vex
vey	vey
vez	vez
vfa	vfa
vfb	vfb
vfc	vfc
vfd	vfd
vfe	vfe
vff	vff
vfg	vfg
vfh	vfh
vfi	vfi
vfj	vfj
vfk	vfk
vfl	vfl
vfm	vfm
vfn	vfn
vfo	vfo
vfp	vfp
vfq	vfq
vfr	vfr
vfs	vfs
vft	vft
vfu	vfu
vfv	vfv
vfw	vfw
vfx	vfx
vfy	vfy
vfz	vfz
vga	vga
vgb	vgb
vgc	vgc
vgd	vgd
vge	vge
vgf	vgf
vgg	vgg
vgh	vgh
vgi	vgi
vgj	vgj
vgk	vgk
vgl	vgl
vgm	vgm
vgn	vgn
vgo	vgo
vgp	vgp
vgq	vgq
vgr	vgr
vgs	vgs
vgt	vgt
vgu	vgu
vgv	vgv
vgw	vgw
vgx	vgx
vgy	vgy
vgz	vgz
vha	vha
vhb	vhb
vhc	vhc
vhd	vhd
vhe	vhe
vhf	vhf
vhg	vhg
vhh	vhh
vhi	vhi
vhj	vhj
vhk	vhk
vhl	vhl
vhm	vhm
vhn	vhn
vho	vho
vhp	vhp
vhq	vhq
vhr	vhr
vhs	vhs
vht	vht
vhu	vhu
vhv	vhv
vhw	vhw
vhx	vhx
vhy	vhy
vhz	vhz
via	via
vib	vib
vic	vic
vid	vid
vie	vie
vif	vif
vig	vig
vih	vih
vii	vii
vij	vij
vik	vik
vil	vil
vim	vim
vin	vin
vio	vio
vip	vip
viq	viq
vir	vir
vis	vis
vit	vit
viu	viu
viv	viv
viw	viw
vix	vix
viy	viy
viz	viz
vja	vja
vjb	vjb
vjc	vjc
vjd	vjd
vje	vje
vjf	vjf
vjg	vjg
vjh	vjh
vji	vji
vjj	vjj
vjk	vjk
vjl	vjl
vjm	vjm
vjn	vjn
vjo	vjo
vjp	vjp
vjq	vjq
vjr	vjr
vjs	vjs
vjt	vjt
vju	vju
vjv	vjv
vjw	vjw
vjx	vjx
vjy	vjy
vjz	vjz
vka	vka
vkb	vkb
vkc	vkc
vkd	vkd
vke	vke
vkf	vkf
vkg	vkg
vkh	vkh
vki	vki
vkj	vkj
vkk	vkk
vkl	vkl
vkm	vkm
vkn	vkn
vko	vko
vkp	vkp
vkq	vkq
vkr	vkr
vks	vks
vkt	vkt
vku	vku
vkv	vkv
vkw	vkw
vkx	vkx
vky	vky
vkz	vkz
vla	vla
vlb	vlb
vlc	vlc
vld	vld
vle	vle
vlf	vlf
vlg	vlg
vlh	vlh
vli	vli
vlj	vlj
vlk	vlk
vll	vll
vlm	vlm
vln	vln
vlo	vlo
vlp	vlp
vlq	vlq
vlr	vlr
vls	vls
vlt	vlt
vlu	vlu
vlv	vlv
vlw	vlw
vlx	vlx
vly	vly
vlz	vlz
vma	vma
vmb	vmb
vmc	vmc
vmd	vmd
vme	vme
vmf	vmf
vmg	vmg
vmh	vmh
vmi	vmi
vmj	vmj
vmk	vmk
vml	vml
vmm	vmm
vmn	vmn
vmo	vmo
vmp	vmp
vmq	vmq
vmr	vmr
vms	vms
vmt	vmt
vmu	vmu
vmv	vmv
vmw	vmw
vmx	vmx
vmy	vmy
vmz	vmz
vna	vna
vnb	vnb
vnc	vnc
vnd	vnd
vne	vne
vnf	vnf
vng	vng
vnh	vnh
vni	vni
vnj	vnj
vnk	vnk
vnl	vnl
vnm	vnm
vnn	vnn
vno	vno
vnp	vnp
vnq	vnq
vnr	vnr
vns	vns
vnt	vnt
vnu	vnu
vnv	vnv
vnw	vnw
vnx	vnx
vny	vny
vnz	vnz
voa	voa
vob	vob
voc	voc
vod	vod
voe	voe
vof	vof
vog	vog
voh	voh
voi	voi
voj	voj
vok	vok
vol	vol
vom	vom
von	von
voo	voo
vop	vop
voq	voq
vor	vor
vos	vos
vot	vot
vou	vou
vov	vov
vow	vow
vox	vox
voy	voy
voz	voz
vpa	vpa
vpb	vpb
vpc	vpc
vpd	vpd
vpe	vpe
vpf	vpf
vpg	vpg
vph	vph
vpi	vpi
vpj	vpj
vpk	vpk
vpl	vpl
vpm	vpm
vpn	vpn
vpo	vpo
vpp	vpp
vpq	vpq
vpr	vpr
vps	vps
vpt	vpt
vpu	vpu
vpv	vpv
vpw	vpw
vpx	vpx
vpy	vpy
vpz	vpz
vqa	vqa
vqb	vqb
vqc	vqc
vqd	vqd
vqe	vqe
vqf	vqf
vqg	vqg
vqh	vqh
vqi	vqi
vqj	vqj
vqk	vqk
vql	vql
vqm	vqm
vqn	vqn
vqo	vqo
vqp	vqp
vqq	vqq
vqr	vqr
vqs	vqs
vqt	vqt
vqu	vqu
vqv	vqv
vqw	vqw
vqx	vqx
vqy	vqy
vqz	vqz
vra	vra
vrb	vrb
vrc	vrc
vrd	vrd
vre	vre
vrf	vrf
vrg	vrg
vrh	vrh
vri	vri
vrj	vrj
vrk	vrk
vrl	vrl
vrm	vrm
vrn	vrn
vro	vro
vrp	vrp
vrq	vrq
vrr	vrr
vrs	vrs
vrt	vrt
vru	vru
vrv	vrv
vrw	vrw
vrx	vrx
vry	vry
vrz	vrz
vsa	vsa
vsb	vsb
vsc	vsc
vsd	vsd
vse	vse
vsf	vsf
vsg	vsg
vsh	vsh
vsi	vsi
vsj	vsj
vsk	vsk
vsl	vsl
vsm	vsm
vsn	vsn
vso	vso
vsp	vsp
vsq	vsq
vsr	vsr
vss	vss
vst	vst
vsu	vsu
vsv	vsv
vsw	vsw
vsx	vsx
vsy	vsy
vsz	vsz
vta	vta
vtb	vtb
vtc	vtc
vtd	vtd
vte	vte
vtf	vtf
vtg	vtg
vth	vth
vti	vti
vtj	vtj
vtk	vtk
vtl	vtl
vtm	vtm
vtn	vtn
vto	vto
vtp	vtp
vtq	vtq
vtr	vtr
vts	vts
vtt	vtt
vtu	vtu
vtv	vtv
vtw	vtw
vtx	vtx
vty	vty
vtz	vtz
vua	vua
vub	vub
vuc	vuc
vud	vud
vue	vue
vuf	vuf
vug	vug
vuh	vuh
vui	vui
vuj	vuj
vuk	vuk
vul	vul
vum	vum
vun	vun
vuo	vuo
vup	vup
vuq	vuq
vur	vur
vus	vus
vut	vut
vuu	vuu
vuv	vuv
vuw	vuw
vux	vux
vuy	vuy
vuz	vuz
vva	vva
vvb	vvb
vvc	vvc
vvd	vvd
vve	vve
vvf	vvf
vvg	vvg
vvh	vvh
vvi	vvi
vvj	vvj
vvk	vvk
vvl	vvl
vvm	vvm
vvn	vvn
vvo	vvo
vvp	vvp
vvq	vvq
vvr	vvr
vvs	vvs
vvt	vvt
vvu	vvu
vvv	vvv
vvw	vvw
vvx	vvx
vvy	vvy
vvz	vvz
vwa	vwa
vwb	vwb
vwc	vwc
vwd	vwd
vwe	vwe
vwf	vwf
vwg	vwg
vwh	vwh
vwi	vwi
vwj	vwj
vwk	vwk
vwl	vwl
vwm	vwm
vwn	vwn
vwo	vwo
vwp	vwp
vwq	vwq
vwr	vwr
vws	vws
vwt	vwt
vwu	vwu
vwv	vwv
vww	vww
vwx	vwx
vwy	vwy
vwz	vwz
vxa	vxa
vxb	vxb
vxc	vxc
vxd	vxd
vxe	vxe
vxf	vxf
vxg	vxg
vxh	vxh
vxi	vxi
vxj	vxj
vxk	vxk
vxl	vxl
vxm	vxm
vxn	vxn
vxo	vxo
vxp	vxp
vxq	vxq
vxr	vxr
vxs	vxs
vxt	vxt
vxu	vxu
vxv	vxv
vxw	vxw
vxx	vxx
vxy	vxy
vxz	vxz
vya	vya
vyb	vyb
vyc	vyc
vyd	vyd
vye	vye
vyf	vyf
vyg	vyg
vyh	vyh
vyi	vyi
vyj	vyj
vyk	vyk
vyl	vyl
vym	vym
vyn	vyn
vyo	vyo
vyp	vyp
vyq	vyq
vyr	vyr
vys	vys
vyt	vyt
vyu	vyu
vyv	vyv
vyw	vyw
vyx	vyx
vyy	vyy
vyz	vyz
vza	vza
vzb	vzb
vzc	vzc
vzd	vzd
vze	vze
vzf	vzf
vzg	vzg
vzh	vzh
vzi	vzi
vzj	vzj
vzk	vzk
vzl	vzl
vzm	vzm
vzn	vzn
vzo	vzo
vzp	vzp
vzq	vzq
vzr	vzr
vzs	vzs
vzt	vzt
vzu	vzu
vzv	vzv
vzw	vzw
vzx	vzx
vzy	vzy
vzz	vzz
waa	waa
wab	wab
wac	wac
wad	wad
wae	wae
waf	waf
wag	wag
wah	wah
wai	wai
waj	waj
wak	wak
wal	wal
wam	wam
wan	wan
wao	wao
wap	wap
waq	waq
war	war
was	was
wat	wat
wau	wau
wav	wav
waw	waw
wax	wax
way	way
waz	waz
wba	wba
wbb	wbb
wbc	wbc
wbd	wbd
wbe	wbe
wbf	wbf
wbg	wbg
wbh	wbh
wbi	wbi
wbj	wbj
wbk	wbk
wbl	wbl
wbm	wbm
wbn	wbn
wbo	wbo
wbp	wbp
wbq	wbq
wbr	wbr
wbs	wbs
wbt	wbt
wbu	wbu
wbv	wbv
wbw	wbw
wbx	wbx
wby	wby
wbz	wbz
wca	wca
wcb	wcb
wcc	wcc
wcd	wcd
wce	wce
wcf	wcf
wcg	wcg
wch	wch
wci	wci
wcj	wcj
wck	wck
wcl	wcl
wcm	wcm
wcn	wcn
wco	wco
wcp	wcp
wcq	wcq
wcr	wcr
wcs	wcs
wct	wct
wcu	wcu
wcv	wcv
wcw	wcw
wcx	wcx
wcy	wcy
wcz	wcz
wda	wda
wdb	wdb
wdc	wdc
wdd	wdd
wde	wde
wdf	wdf
wdg	wdg
wdh	wdh
wdi	wdi
wdj	wdj
wdk	wdk
wdl	wdl
wdm	wdm
wdn	wdn
wdo	wdo
wdp	wdp
wdq	wdq
wdr	wdr
wds	wds
wdt	wdt
wdu	wdu
wdv	wdv
wdw	wdw
wdx	wdx
wdy	wdy
wdz	wdz
wea	wea
web	web
wec	wec
wed	wed
wee	wee
wef	wef
weg	weg
weh	weh
wei	wei
wej	wej
wek	wek
wel	wel
wem	wem
wen	wen
weo	weo
wep	wep
weq	weq
wer	wer
wes	wes
wet	wet
weu	weu
wev	wev
wew	wew
wex	wex
wey	wey
wez	wez
wfa	wfa
wfb	wfb
wfc	wfc
wfd	wfd
wfe	wfe
wff	wff
wfg	wfg
wfh	wfh
wfi	wfi
wfj	wfj
wfk	wfk
wfl	wfl
wfm	wfm
wfn	wfn
wfo	wfo
wfp	wfp
wfq	wfq
wfr	wfr
wfs	wfs
wft	wft
wfu	wfu
wfv	wfv
wfw	wfw
wfx	wfx
wfy	wfy
wfz	wfz
wga	wga
wgb	wgb
wgc	wgc
wgd	wgd
wge	wge
wgf	wgf
wgg	wgg
wgh	wgh
wgi	wgi
wgj	wgj
wgk	wgk
wgl	wgl
wgm	wgm
wgn	wgn
wgo	wgo
wgp	wgp
wgq	wgq
wgr	wgr
wgs	wgs
wgt	wgt
wgu	wgu
wgv	wgv
wgw	wgw
wgx	wgx
wgy	wgy
wgz	wgz
wha	wha
whb	whb
whc	whc
whd	whd
whe	whe
whf	whf
whg	whg
whh	whh
whi	whi
whj	whj
whk	whk
whl	whl
whm	whm
whn	whn
who	who
whp	whp
whq	whq
whr	whr
whs	whs
wht	wht
whu	whu
whv	whv
whw	whw
whx	whx
why	why
whz	whz
wia	wia
wib	wib
wic	wic
wid	wid
wie	wie
wif	wif
wig	wig
wih	wih
wii	wii
wij	wij
wik	wik
wil	wil
wim	wim
win	win
wio	wio
wip	wip
wiq	wiq
wir	wir
wis	wis
wit	wit
wiu	wiu
wiv	wiv
wiw	wiw
wix	wix
wiy	wiy
wiz	wiz
wja	wja
wjb	wjb
wjc	wjc
wjd	wjd
wje	wje
wjf	wjf
wjg	wjg
wjh	wjh
wji	wji
wjj	wjj
wjk	wjk
wjl	wjl
wjm	wjm
wjn	wjn
wjo	wjo
wjp	wjp
wjq	wjq
wjr	wjr
wjs	wjs
wjt	wjt
wju	wju
wjv	wjv
wjw	wjw
wjx	wjx
wjy	wjy
wjz	wjz
wka	wka
wkb	wkb
wkc	wkc
wkd	wkd
wke	wke
wkf	wkf
wkg	wkg
wkh	wkh
wki	wki
wkj	wkj
wkk	wkk
wkl	wkl
wkm	wkm
wkn	wkn
wko	wko
wkp	wkp
wkq	wkq
wkr	wkr
wks	wks
wkt	wkt
wku	wku
wkv	wkv
wkw	wkw
wkx	wkx
wky	wky
wkz	wkz
wla	wla
wlb	wlb
wlc	wlc
wld	wld
wle	wle
wlf	wlf
wlg	wlg
wlh	wlh
wli	wli
wlj	wlj
wlk	wlk
wll	wll
wlm	wlm
wln	wln
wlo	wlo
wlp	wlp
wlq	wlq
wlr	wlr
wls	wls
wlt	wlt
wlu	wlu
wlv	wlv
wlw	wlw
wlx	wlx
wly	wly
wlz	wlz
wma	wma
wmb	wmb
wmc	wmc
wmd	wmd
wme	wme
wmf	wmf
wmg	wmg
wmh	wmh
wmi	wmi
wmj	wmj
wmk	wmk
wml	wml
wmm	wmm
wmn	wmn
wmo	wmo
wmp	wmp
wmq	wmq
wmr	wmr
wms	wms
wmt	wmt
wmu	wmu
wmv	wmv
wmw	wmw
wmx	wmx
wmy	wmy
wmz	wmz
wna	wna
wnb	wnb
wnc	wnc
wnd	wnd
wne	wne
wnf	wnf
wng	wng
wnh	wnh
wni	wni
wnj	wnj
wnk	wnk
wnl	wnl
wnm	wnm
wnn	wnn
wno	wno
wnp	wnp
wnq	wnq
wnr	wnr
wns	wns
wnt	wnt
wnu	wnu
wnv	wnv
wnw	wnw
wnx	wnx
wny	wny
wnz	wnz
woa	woa
wob	wob
woc	woc
wod	wod
woe	woe
wof	wof
wog	wog
woh	woh
woi	woi
woj	woj
wok	wok
wol	wol
wom	wom
won	won
woo	woo
wop	wop
woq	woq
wor	wor
wos	wos
wot	wot
wou	wou
wov	wov
wow	wow
wox	wox
woy	woy
woz	woz
wpa	wpa
wpb	wpb
wpc	wpc
wpd	wpd
wpe	wpe
wpf	wpf
wpg	wpg
wph	wph
wpi	wpi
wpj	wpj
wpk	wpk
wpl	wpl
wpm	wpm
wpn	wpn
wpo	wpo
wpp	wpp
wpq	wpq
wpr	wpr
wps	wps
wpt	wpt
wpu	wpu
wpv	wpv
wpw	wpw
wpx	wpx
wpy	wpy
wpz	wpz
wqa	wqa
wqb	wqb
wqc	wqc
wqd	wqd
wqe	wqe
wqf	wqf
wqg	wqg
wqh	wqh
wqi	wqi
wqj	wqj
wqk	wqk
wql	wql
wqm	wqm
wqn	wqn
wqo	wqo
wqp	wqp
wqq	wqq
wqr	wqr
wqs	wqs
wqt	wqt
wqu	wqu
wqv	wqv
wqw	wqw
wqx	wqx
wqy	wqy
wqz	wqz
wra	wra
wrb	wrb
wrc	wrc
wrd	wrd
wre	wre
wrf	wrf
wrg	wrg
wrh	wrh
wri	wri
wrj	wrj
wrk	wrk
wrl	wrl
wrm	wrm
wrn	wrn
wro	wro
wrp	wrp
wrq	wrq
wrr	wrr
wrs	wrs
wrt	wrt
wru	wru
wrv	wrv
wrw	wrw
wrx	wrx
wry	wry
wrz	wrz
wsa	wsa
wsb	wsb
wsc	wsc
wsd	wsd
wse	wse
wsf	wsf
wsg	wsg
wsh	wsh
wsi	wsi
wsj	wsj
wsk	wsk
wsl	wsl
wsm	wsm
wsn	wsn
wso	wso
wsp	wsp
wsq	wsq
wsr	wsr
wss	wss
wst	wst
wsu	wsu
wsv	wsv
wsw	wsw
wsx	wsx
wsy	wsy
wsz	wsz
wta	wta
wtb	wtb
wtc	wtc
wtd	wtd
wte	wte
wtf	wtf
wtg	wtg
wth	wth
wti	wti
wtj	wtj
wtk	wtk
wtl	wtl
wtm	wtm
wtn	wtn
wto	wto
wtp	wtp
wtq	wtq
wtr	wtr
wts	wts
wtt	wtt
wtu	wtu
wtv	wtv
wtw	wtw
wtx	wtx
wty	wty
wtz	wtz
wua	wua
wub	wub
wuc	wuc
wud	wud
wue	wue
wuf	wuf
wug	wug
wuh	wuh
wui	wui
wuj	wuj
wuk	wuk
wul	wul
wum	wum
wun	wun
wuo	wuo
wup	wup
wuq	wuq
wur	wur
wus	wus
wut	wut
wuu	wuu
wuv	wuv
wuw	wuw
wux	wux
wuy	wuy
wuz	wuz
wva	wva
wvb	wvb
wvc	wvc
wvd	wvd
wve	wve
wvf	wvf
wvg	wvg
wvh	wvh
wvi	wvi
wvj	wvj
wvk	wvk
wvl	wvl
wvm	wvm
wvn	wvn
wvo	wvo
wvp	wvp
wvq	wvq
wvr	wvr
wvs	wvs
wvt	wvt
wvu	wvu
wvv	wvv
wvw	wvw
wvx	wvx
wvy	wvy
wvz	wvz
wwa	wwa
wwb	wwb
wwc	wwc
wwd	wwd
wwe	wwe
wwf	wwf
wwg	wwg
wwh	wwh
wwi	wwi
wwj	wwj
wwk	wwk
wwl	wwl
wwm	wwm
wwn	wwn
wwo	wwo
wwp	wwp
wwq	wwq
wwr	wwr
wws	wws
wwt	wwt
wwu	wwu
wwv	wwv
www	www
wwx	wwx
wwy	wwy
wwz	wwz
wxa	wxa
wxb	wxb
wxc	wxc
wxd	wxd
wxe	wxe
wxf	wxf
wxg	wxg
wxh	wxh
wxi	wxi
wxj	wxj
wxk	wxk
wxl	wxl
wxm	wxm
wxn	wxn
wxo	wxo
wxp	wxp
wxq	wxq
wxr	wxr
wxs	wxs
wxt	wxt
wxu	wxu
wxv	wxv
wxw	wxw
wxx	wxx
wxy	wxy
wxz	wxz
wya	wya
wyb	wyb
wyc	wyc
wyd	wyd
wye	wye
wyf	wyf
wyg	wyg
wyh	wyh
wyi	wyi
wyj	wyj
wyk	wyk
wyl	wyl
wym	wym
wyn	wyn
wyo	wyo
wyp	wyp
wyq	wyq
wyr	wyr
wys	wys
wyt	wyt
wyu	wyu
wyv	wyv
wyw	wyw
wyx	wyx
wyy	wyy
wyz	wyz
wza	wza
wzb	wzb
wzc	wzc
wzd	wzd
wze	wze
wzf	wzf
wzg	wzg
wzh	wzh
wzi	wzi
wzj	wzj
wzk	wzk
wzl	wzl
wzm	wzm
wzn	wzn
wzo	wzo
wzp	wzp
wzq	wzq
wzr	wzr
wzs	wzs
wzt	wzt
wzu	wzu
wzv	wzv
wzw	wzw
wzx	wzx
wzy	wzy
wzz	wzz
xaa	xaa
xab	xab
xac	xac
xad	xad
xae	xae
xaf	xaf
xag	xag
xah	xah
xai	xai
xaj	xaj
xak	xak
xal	xal
xam	xam
xan	xan
xao	xao
xap	xap
xaq	xaq
xar	xar
xas	xas
xat	xat
xau	xau
xav	xav
xaw	xaw
xax	xax
xay	xay
xaz	xaz
xba	xba
xbb	xbb
xbc	xbc
xbd	xbd
xbe	xbe
xbf	xbf
xbg	xbg
xbh	xbh
xbi	xbi
xbj	xbj
xbk	xbk
xbl	xbl
xbm	xbm
xbn	xbn
xbo	xbo
xbp	xbp
xbq	xbq
xbr	xbr
xbs	xbs
xbt	xbt
xbu	xbu
xbv	xbv
xbw	xbw
xbx	xbx
xby	xby
xbz	xbz
xca	xca
xcb	xcb
xcc	xcc
xcd	xcd
xce	xce
xcf	xcf
xcg	xcg
xch	xch
xci	xci
xcj	xcj
xck	xck
xcl	xcl
xcm	xcm
xcn	xcn
xco	xco
xcp	xcp
xcq	xcq
xcr	xcr
xcs	xcs
xct	xct
xcu	xcu
xcv	xcv
xcw	xcw
xcx	xcx
xcy	xcy
xcz	xcz
xda	xda
xdb	xdb
xdc	xdc
xdd	xdd
xde	xde
xdf	xdf
xdg	xdg
xdh	xdh
xdi	xdi
xdj	xdj
xdk	xdk
xdl	xdl
xdm	xdm
xdn	xdn
xdo	xdo
xdp	xdp
xdq	xdq
xdr	xdr
xds	xds
xdt	xdt
xdu	xdu
xdv	xdv
xdw	xdw
xdx	xdx
xdy	xdy
xdz	xdz
xea	xea
xeb	xeb
xec	xec
xed	xed
xee	xee
xef	xef
xeg	xeg
xeh	xeh
xei	xei
xej	xej
xek	xek
xel	xel
xem	xem
xen	xen
xeo	xeo
xep	xep
xeq	xeq
xer	xer
xes	xes
xet	xet
xeu	xeu
xev	xev
xew	xew
xex	xex
xey	xey
xez	xez
xfa	xfa
xfb	xfb
xfc	xfc
xfd	xfd
xfe	xfe
xff	xff
xfg	xfg
xfh	xfh
xfi	xfi
xfj	xfj
xfk	xfk
xfl	xfl
xfm	xfm
xfn	xfn
xfo	xfo
xfp	xfp
xfq	xfq
xfr	xfr
xfs	xfs
xft	xft
xfu	xfu
xfv	xfv
xfw	xfw
xfx	xfx
xfy	xfy
xfz	xfz
xga	xga
xgb	xgb
xgc	xgc
xgd	xgd
xge	xge
xgf	xgf
xgg	xgg
xgh	xgh
xgi	xgi
xgj	xgj
xgk	xgk
xgl	xgl
xgm	xgm
xgn	xgn
xgo	xgo
xgp	xgp
xgq	xgq
xgr	xgr
xgs	xgs
xgt	xgt
xgu	xgu
xgv	xgv
xgw	xgw
xgx	xgx
xgy	xgy
xgz	xgz
xha	xha
xhb	xhb
xhc	xhc
xhd	xhd
xhe	xhe
xhf	xhf
xhg	xhg
xhh	xhh
xhi	xhi
xhj	xhj
xhk	xhk
xhl	xhl
xhm	xhm
xhn	xhn
xho	xho
xhp	xhp
xhq	xhq
xhr	xhr
xhs	xhs
xht	xht
xhu	xhu
xhv	xhv
xhw	xhw
xhx	xhx
xhy	xhy
xhz	xhz
xia	xia
xib	xib
xic	xic
xid	xid
xie	xie
xif	xif
xig	xig
xih	xih
xii	xii
xij	xij
xik	xik
xil	xil
xim	xim
xin	xin
xio	xio
xip	xip
xiq	xiq
xir	xir
xis	xis
xit	xit
xiu	xiu
xiv	xiv
xiw	xiw
xix	xix
xiy	xiy
xiz	xiz
xja	xja
xjb	xjb
xjc	xjc
xjd	xjd
xje	xje
xjf	xjf
xjg	xjg
xjh	xjh
xji	xji
xjj	xjj
xjk	xjk
xjl	xjl
xjm	xjm
xjn	xjn
xjo	xjo
xjp	xjp
xjq	xjq
xjr	xjr
xjs	xjs
xjt	xjt
xju	xju
xjv	xjv
xjw	xjw
xjx	xjx
xjy	xjy
xjz	xjz
xka	xka
xkb	xkb
xkc	xkc
xkd	xkd
xke	xke
xkf	xkf
xkg	xkg
xkh	xkh
xki	xki
xkj	xkj
xkk	xkk
xkl	xkl
xkm	xkm
xkn	xkn
xko	xko
xkp	xkp
xkq	xkq
xkr	xkr
xks	xks
xkt	xkt
xku	xku
xkv	xkv
xkw	xkw
xkx	xkx
xky	xky
xkz	xkz
xla	xla
xlb	xlb
xlc	xlc
xld	xld
xle	xle
xlf	xlf
xlg	xlg
xlh	xlh
xli	xli
xlj	xlj
xlk	xlk
xll	xll
xlm	xlm
xln	xln
xlo	xlo
xlp	xlp
xlq	xlq
xlr	xlr
xls	xls
xlt	xlt
xlu	xlu
xlv	xlv
xlw	xlw
xlx	xlx
xly	xly
xlz	xlz
xma	xma
xmb	xmb
xmc	xmc
xmd	xmd
xme	xme
xmf	xmf
xmg	xmg
xmh	xmh
xmi	xmi
xmj	xmj
xmk	xmk
xml	xml
xmm	xmm
xmn	xmn
xmo	xmo
xmp	xmp
xmq	xmq
xmr	xmr
xms	xms
xmt	xmt
xmu	xmu
xmv	xmv
xmw	xmw
xmx	xmx
xmy	xmy
xmz	xmz
xna	xna
xnb	xnb
xnc	xnc
xnd	xnd
xne	xne
xnf	xnf
xng	xng
xnh	xnh
xni	xni
xnj	xnj
xnk	xnk
xnl	xnl
xnm	xnm
xnn	xnn
xno	xno
xnp	xnp
xnq	xnq
xnr	xnr
xns	xns
xnt	xnt
xnu	xnu
xnv	xnv
xnw	xnw
xnx	xnx
xny	xny
xnz	xnz
xoa	xoa
xob	xob
xoc	xoc
xod	xod
xoe	xoe
xof	xof
xog	xog
xoh	xoh
xoi	xoi
xoj	xoj
xok	xok
xol	xol
xom	xom
xon	xon
xoo	xoo
xop	xop
xoq	xoq
xor	xor
xos	xos
xot	xot
xou	xou
xov	xov
xow	xow
xox	xox
xoy	xoy
xoz	xoz
xpa	xpa
xpb	xpb
xpc	xpc
xpd	xpd
xpe	xpe
xpf	xpf
xpg	xpg
xph	xph
xpi	xpi
xpj	xpj
xpk	xpk
xpl	xpl
xpm	xpm
xpn	xpn
xpo	xpo
xpp	xpp
xpq	xpq
xpr	xpr
xps	xps
xpt	xpt
xpu	xpu
xpv	xpv
xpw	xpw
xpx	xpx
xpy	xpy
xpz	xpz
xqa	xqa
xqb	xqb
xqc	xqc
xqd	xqd
xqe	xqe
xqf	xqf
xqg	xqg
xqh	xqh
xqi	xqi
xqj	xqj
xqk	xqk
xql	xql
xqm	xqm
xqn	xqn
xqo	xqo
xqp	xqp
xqq	xqq
xqr	xqr
xqs	xqs
xqt	xqt
xqu	xqu
xqv	xqv
xqw	xqw
xqx	xqx
xqy	xqy
xqz	xqz
xra	xra
xrb	xrb
xrc	xrc
xrd	xrd
xre	xre
xrf	xrf
xrg	xrg
xrh	xrh
xri	xri
xrj	xrj
xrk	xrk
xrl	xrl
xrm	xrm
xrn	xrn
xro	xro
xrp	xrp
xrq	xrq
xrr	xrr
xrs	xrs
xrt	xrt
xru	xru
xrv	xrv
xrw	xrw
xrx	xrx
xry	xry
xrz	xrz
xsa	xsa
xsb	xsb
xsc	xsc
xsd	xsd
xse	xse
xsf	xsf
xsg	xsg
xsh	xsh
xsi	xsi
xsj	xsj
xsk	xsk
xsl	xsl
xsm	xsm
xsn	xsn
xso	xso
xsp	xsp
xsq	xsq
xsr	xsr
xss	xss
xst	xst
xsu	xsu
xsv	xsv
xsw	xsw
xsx	xsx
xsy	xsy
xsz	xsz
xta	xta
xtb	xtb
xtc	xtc
xtd	xtd
xte	xte
xtf	xtf
xtg	xtg
xth	xth
xti	xti
xtj	xtj
xtk	xtk
xtl	xtl
xtm	xtm
xtn	xtn
xto	xto
xtp	xtp
xtq	xtq
xtr	xtr
xts	xts
xtt	xtt
xtu	xtu
xtv	xtv
xtw	xtw
xtx	xtx
xty	xty
xtz	xtz
xua	xua
xub	xub
xuc	xuc
xud	xud
xue	xue
xuf	xuf
xug	xug
xuh	xuh
xui	xui
xuj	xuj
xuk	xuk
xul	xul
xum	xum
xun	xun
xuo	xuo
xup	xup
xuq	xuq
xur	xur
xus	xus
xut	xut
xuu	xuu
xuv	xuv
xuw	xuw
xux	xux
xuy	xuy
xuz	xuz
xva	xva
xvb	xvb
xvc	xvc
xvd	xvd
xve	xve
xvf	xvf
xvg	xvg
xvh	xvh
xvi	xvi
xvj	xvj
xvk	xvk
xvl	xvl
xvm	xvm
xvn	xvn
xvo	xvo
xvp	xvp
xvq	xvq
xvr	xvr
xvs	xvs
xvt	xvt
xvu	xvu
xvv	xvv
xvw	xvw
xvx	xvx
xvy	xvy
xvz	xvz
xwa	xwa
xwb	xwb
xwc	xwc
xwd	xwd
xwe	xwe
xwf	xwf
xwg	xwg
xwh	xwh
xwi	xwi
xwj	xwj
xwk	xwk
xwl	xwl
xwm	xwm
xwn	xwn
xwo	xwo
xwp	xwp
xwq	xwq
xwr	xwr
xws	xws
xwt	xwt
xwu	xwu
xwv	xwv
xww	xww
xwx	xwx
xwy	xwy
xwz	xwz
xxa	xxa
xxb	xxb
xxc	xxc
xxd	xxd
xxe	xxe
xxf	xxf
xxg	xxg
xxh	xxh
xxi	xxi
xxj	xxj
xxk	xxk
xxl	xxl
xxm	xxm
xxn	xxn
xxo	xxo
xxp	xxp
xxq	xxq
xxr	xxr
xxs	xxs
xxt	xxt
xxu	xxu
xxv	xxv
xxw	xxw
xxx	xxx
xxy	xxy
xxz	xxz
xya	xya
xyb	xyb
xyc	xyc
xyd	xyd
xye	xye
xyf	xyf
xyg	xyg
xyh	xyh
xyi	xyi
xyj	xyj
xyk	xyk
xyl	xyl
xym	xym
xyn	xyn
xyo	xyo
xyp	xyp
xyq	xyq
xyr	xyr
xys	xys
xyt	xyt
xyu	xyu
xyv	xyv
xyw	xyw
xyx	xyx
xyy	xyy
xyz	xyz
xza	xza
xzb	xzb
xzc	xzc
xzd	xzd
xze	xze
xzf	xzf
xzg	xzg
xzh	xzh
xzi	xzi
xzj	xzj
xzk	xzk
xzl	xzl
xzm	xzm
xzn	xzn
xzo	xzo
xzp	xzp
xzq	xzq
xzr	xzr
xzs	xzs
xzt	xzt
xzu	xzu
xzv	xzv
xzw	xzw
xzx	xzx
xzy	xzy
xzz	xzz
yaa	yaa
yab	yab
yac	yac
yad	yad
yae	yae
yaf	yaf
yag	yag
yah	yah
yai	yai
yaj	yaj
yak	yak
yal	yal
yam	yam
yan	yan
yao	yao
yap	yap
yaq	yaq
yar	yar
yas	yas
yat	yat
yau	yau
yav	yav
yaw	yaw
yax	yax
yay	yay
yaz	yaz
yba	yba
ybb	ybb
ybc	ybc
ybd	ybd
ybe	ybe
ybf	ybf
ybg	ybg
ybh	ybh
ybi	ybi
ybj	ybj
ybk	ybk
ybl	ybl
ybm	ybm
ybn	ybn
ybo	ybo
ybp	ybp
ybq	ybq
ybr	ybr
ybs	ybs
ybt	ybt
ybu	ybu
ybv	ybv
ybw	ybw
ybx	ybx
yby	yby
ybz	ybz
yca	yca
ycb	ycb
ycc	ycc
ycd	ycd
yce	yce
ycf	ycf
ycg	ycg
ych	ych
yci	yci
ycj	ycj
yck	yck
ycl	ycl
ycm	ycm
ycn	ycn
yco	yco
ycp	ycp
ycq	ycq
ycr	ycr
ycs	ycs
yct	yct
ycu	ycu
ycv	ycv
ycw	ycw
ycx	ycx
ycy	ycy
ycz	ycz
yda	yda
ydb	ydb
ydc	ydc
ydd	ydd
yde	yde
ydf	ydf
ydg	ydg
ydh	ydh
ydi	ydi
ydj	ydj
ydk	ydk
ydl	ydl
ydm	ydm
ydn	ydn
ydo	ydo
ydp	ydp
ydq	ydq
ydr	ydr
yds	yds
ydt	ydt
ydu	ydu
ydv	ydv
ydw	ydw
ydx	ydx
ydy	ydy
ydz	ydz
yea	yea
yeb	yeb
yec	yec
yed	yed
yee	yee
yef	yef
yeg	yeg
yeh	yeh
yei	yei
yej	yej
yek	yek
yel	yel
yem	yem
yen	yen
yeo	yeo
yep	yep
yeq	yeq
yer	yer
yes	yes
yet	yet
yeu	yeu
yev	yev
yew	yew
yex	yex
yey	yey
yez	yez
yfa	yfa
yfb	yfb
yfc	yfc
yfd	yfd
yfe	yfe
yff	yff
yfg	yfg
yfh	yfh
yfi	yfi
yfj	yfj
yfk	yfk
yfl	yfl
yfm	yfm
yfn	yfn
yfo	yfo
yfp	yfp
yfq	yfq
yfr	yfr
yfs	yfs
yft	yft
yfu	yfu
yfv	yfv
yfw	yfw
yfx	yfx
yfy	yfy
yfz	yfz
yga	yga
ygb	ygb
ygc	ygc
ygd	ygd
yge	yge
ygf	ygf
ygg	ygg
ygh	ygh
ygi	ygi
ygj	ygj
ygk	ygk
ygl	ygl
ygm	ygm
ygn	ygn
ygo	ygo
ygp	ygp
ygq	ygq
ygr	ygr
ygs	ygs
ygt	ygt
ygu	ygu
ygv	ygv
ygw	ygw
ygx	ygx
ygy	ygy
ygz	ygz
yha	yha
yhb	yhb
yhc	yhc
yhd	yhd
yhe	yhe
yhf	yhf
yhg	yhg
yhh	yhh
yhi	yhi
yhj	yhj
yhk	yhk
yhl	yhl
yhm	yhm
yhn	yhn
yho	yho
yhp	yhp
yhq	yhq
yhr	yhr
yhs	yhs
yht	yht
yhu	yhu
yhv	yhv
yhw	yhw
yhx	yhx
yhy	yhy
yhz	yhz
yia	yia
yib	yib
yic	yic
yid	yid
yie	yie
yif	yif
yig	yig
yih	yih
yii	yii
yij	yij
yik	yik
yil	yil
yim	yim
yin	yin
yio	yio
yip	yip
yiq	yiq
yir	yir
yis	yis
yit	yit
yiu	yiu
yiv	yiv
yiw	yiw
yix	yix
yiy	yiy
yiz	yiz
yja	yja
yjb	yjb
yjc	yjc
yjd	yjd
yje	yje
yjf	yjf
yjg	yjg
yjh	yjh
yji	yji
yjj	yjj
yjk	yjk
yjl	yjl
yjm	yjm
yjn	yjn
yjo	yjo
yjp	yjp
yjq	yjq
yjr	yjr
yjs	yjs
yjt	yjt
yju	yju
yjv	yjv
yjw	yjw
yjx	yjx
yjy	yjy
yjz	yjz
yka	yka
ykb	ykb
ykc	ykc
ykd	ykd
yke	yke
ykf	ykf
ykg	ykg
ykh	ykh
yki	yki
ykj	ykj
ykk	ykk
ykl	ykl
ykm	ykm
ykn	ykn
yko	yko
ykp	ykp
ykq	ykq
ykr	ykr
yks	yks
ykt	ykt
yku	yku
ykv	ykv
ykw	ykw
ykx	ykx
yky	yky
ykz	ykz
yla	yla
ylb	ylb
ylc	ylc
yld	yld
yle	yle
ylf	ylf
ylg	ylg
ylh	ylh
yli	yli
ylj	ylj
ylk	ylk
yll	yll
ylm	ylm
yln	yln
ylo	ylo
ylp	ylp
ylq	ylq
ylr	ylr
yls	yls
ylt	ylt
ylu	ylu
ylv	ylv
ylw	ylw
ylx	ylx
yly	yly
ylz	ylz
yma	yma
ymb	ymb
ymc	ymc
ymd	ymd
yme	yme
ymf	ymf
ymg	ymg
ymh	ymh
ymi	ymi
ymj	ymj
ymk	ymk
yml	yml
ymm	ymm
ymn	ymn
ymo	ymo
ymp	ymp
ymq	ymq
ymr	ymr
yms	yms
ymt	ymt
ymu	ymu
ymv	ymv
ymw	ymw
ymx	ymx
ymy	ymy
ymz	ymz
yna	yna
ynb	ynb
ync	ync
ynd	ynd
yne	yne
ynf	ynf
yng	yng
ynh	ynh
yni	yni
ynj	ynj
ynk	ynk
ynl	ynl
ynm	ynm
ynn	ynn
yno	yno
ynp	ynp
ynq	ynq
ynr	ynr
yns	yns
ynt	ynt
ynu	ynu
ynv	ynv
ynw	ynw
ynx	ynx
yny	yny
ynz	ynz
yoa	yoa
yob	yob
yoc	yoc
yod	yod
yoe	yoe
yof	yof
yog	yog
yoh	yoh
yoi	yoi
yoj	yoj
yok	yok
yol	yol
yom	yom
yon	yon
yoo	yoo
yop	yop
yoq	yoq
yor	yor
yos	yos
yot	yot
you	you
yov	yov
yow	yow
yox	yox
yoy	yoy
yoz	yoz
ypa	ypa
ypb	ypb
ypc	ypc
ypd	ypd
ype	ype
ypf	ypf
ypg	ypg
yph	yph
ypi	ypi
ypj	ypj
ypk	ypk
ypl	ypl
ypm	ypm
ypn	ypn
ypo	ypo
ypp	ypp
ypq	ypq
ypr	ypr
yps	yps
ypt	ypt
ypu	ypu
ypv	ypv
ypw	ypw
ypx	ypx
ypy	ypy
ypz	ypz
yqa	yqa
yqb	yqb
yqc	yqc
yqd	yqd
yqe	yqe
yqf	yqf
yqg	yqg
yqh	yqh
yqi	yqi
yqj	yqj
yqk	yqk
yql	yql
yqm	yqm
yqn	yqn
yqo	yqo
yqp	yqp
yqq	yqq
yqr	yqr
yqs	yqs
yqt	yqt
yqu	yqu
yqv	yqv
yqw	yqw
yqx	yqx
yqy	yqy
yqz	yqz
yra	yra
yrb	yrb
yrc	yrc
yrd	yrd
yre	yre
yrf	yrf
yrg	yrg
yrh	yrh
yri	yri
yrj	yrj
yrk	yrk
yrl	yrl
yrm	yrm
yrn	yrn
yro	yro
yrp	yrp
yrq	yrq
yrr	yrr
yrs	yrs
yrt	yrt
yru	yru
yrv	yrv
yrw	yrw
yrx	yrx
yry	yry
yrz	yrz
ysa	ysa
ysb	ysb
ysc	ysc
ysd	ysd
yse	yse
ysf	ysf
ysg	ysg
ysh	ysh
ysi	ysi
ysj	ysj
ysk	ysk
ysl	ysl
ysm	ysm
ysn	ysn
yso	yso
ysp	ysp
ysq	ysq
ysr	ysr
yss	yss
yst	yst
ysu	ysu
ysv	ysv
ysw	ysw
ysx	ysx
ysy	ysy
ysz	ysz
yta	yta
ytb	ytb
ytc	ytc
ytd	ytd
yte	yte
ytf	ytf
ytg	ytg
yth	yth
yti	yti
ytj	ytj
ytk	ytk
ytl	ytl
ytm	ytm
ytn	ytn
yto	yto
ytp	ytp
ytq	ytq
ytr	ytr
yts	yts
ytt	ytt
ytu	ytu
ytv	ytv
ytw	ytw
ytx	ytx
yty	yty
ytz	ytz
yua	yua
yub	yub
yuc	yuc
yud	yud
yue	yue
yuf	yuf
yug	yug
yuh	yuh
yui	yui
yuj	yuj
yuk	yuk
yul	yul
yum	yum
yun	yun
yuo	yuo
yup	yup
yuq	yuq
yur	yur
yus	yus
yut	yut
yuu	yuu
yuv	yuv
yuw	yuw
yux	yux
yuy	yuy
yuz	yuz
yva	yva
yvb	yvb
yvc	yvc
yvd	yvd
yve	yve
yvf	yvf
yvg	yvg
yvh	yvh
yvi	yvi
yvj	yvj
yvk	yvk
yvl	yvl
yvm	yvm
yvn	yvn
yvo	yvo
yvp	yvp
yvq	yvq
yvr	yvr
yvs	yvs
yvt	yvt
yvu	yvu
yvv	yvv
yvw	yvw
yvx	yvx
yvy	yvy
yvz	yvz
ywa	ywa
ywb	ywb
ywc	ywc
ywd	ywd
ywe	ywe
ywf	ywf
ywg	ywg
ywh	ywh
ywi	ywi
ywj	ywj
ywk	ywk
ywl	ywl
ywm	ywm
ywn	ywn
ywo	ywo
ywp	ywp
ywq	ywq
ywr	ywr
yws	yws
ywt	ywt
ywu	ywu
ywv	ywv
yww	yww
ywx	ywx
ywy	ywy
ywz	ywz
yxa	yxa
yxb	yxb
yxc	yxc
yxd	yxd
yxe	yxe
yxf	yxf
yxg	yxg
yxh	yxh
yxi	yxi
yxj	yxj
yxk	yxk
yxl	yxl
yxm	yxm
yxn	yxn
yxo	yxo
yxp	yxp
yxq	yxq
yxr	yxr
yxs	yxs
yxt	yxt
yxu	yxu
yxv	yxv
yxw	yxw
yxx	yxx
yxy	yxy
yxz	yxz
yya	yya
yyb	yyb
yyc	yyc
yyd	yyd
yye	yye
yyf	yyf
yyg	yyg
yyh	yyh
yyi	yyi
yyj	yyj
yyk	yyk
yyl	yyl
yym	yym
yyn	yyn
yyo	yyo
yyp	yyp
yyq	yyq
yyr	yyr
yys	yys
yyt	yyt
yyu	yyu
yyv	yyv
yyw	yyw
yyx	yyx
yyy	yyy
yyz	yyz
yza	yza
yzb	yzb
yzc	yzc
yzd	yzd
yze	yze
yzf	yzf
yzg	yzg
yzh	yzh
yzi	yzi
yzj	yzj
yzk	yzk
yzl	yzl
yzm	yzm
yzn	yzn
yzo	yzo
yzp	yzp
yzq	yzq
yzr	yzr
yzs	yzs
yzt	yzt
yzu	yzu
yzv	yzv
yzw	yzw
yzx	yzx
yzy	yzy
yzz	yzz
zaa	zaa
zab	zab
zac	zac
zad	zad
zae	zae
zaf	zaf
zag	zag
zah	zah
zai	zai
zaj	zaj
zak	zak
zal	zal
zam	zam
zan	zan
zao	zao
zap	zap
zaq	zaq
zar	zar
zas	zas
zat	zat
zau	zau
zav	zav
zaw	zaw
zax	zax
zay	zay
zaz	zaz
zba	zba
zbb	zbb
zbc	zbc
zbd	zbd
zbe	zbe
zbf	zbf
zbg	zbg
zbh	zbh
zbi	zbi
zbj	zbj
zbk	zbk
zbl	zbl
zbm	zbm
zbn	zbn
zbo	zbo
zbp	zbp
zbq	zbq
zbr	zbr
zbs	zbs
zbt	zbt
zbu	zbu
zbv	zbv
zbw	zbw
zbx	zbx
zby	zby
zbz	zbz
zca	zca
zcb	zcb
zcc	zcc
zcd	zcd
zce	zce
zcf	zcf
zcg	zcg
zch	zch
zci	zci
zcj	zcj
zck	zck
zcl	zcl
zcm	zcm
zcn	zcn
zco	zco
zcp	zcp
zcq	zcq
zcr	zcr
zcs	zcs
zct	zct
zcu	zcu
zcv	zcv
zcw	zcw
zcx	zcx
zcy	zcy
zcz	zcz
zda	zda
zdb	zdb
zdc	zdc
zdd	zdd
zde	zde
zdf	zdf
zdg	zdg
zdh	zdh
zdi	zdi
zdj	zdj
zdk	zdk
zdl	zdl
zdm	zdm
zdn	zdn
zdo	zdo
zdp	zdp
zdq	zdq
zdr	zdr
zds	zds
zdt	zdt
zdu	zdu
zdv	zdv
zdw	zdw
zdx	zdx
zdy	zdy
zdz	zdz
zea	zea
zeb	zeb
zec	zec
zed	zed
zee	zee
zef	zef
zeg	zeg
zeh	zeh
zei	zei
zej	zej
zek	zek
zel	zel
zem	zem
zen	zen
zeo	zeo
zep	zep
zeq	zeq
zer	zer
zes	zes
zet	zet
zeu	zeu
zev	zev
zew	zew
zex	zex
zey	zey
zez	zez
zfa	zfa
zfb	zfb
zfc	zfc
zfd	zfd
zfe	zfe
zff	zff
zfg	zfg
zfh	zfh
zfi	zfi
zfj	zfj
zfk	zfk
zfl	zfl
zfm	zfm
zfn	zfn
zfo	zfo
zfp	zfp
zfq	zfq
zfr	zfr
zfs	zfs
zft	zft
zfu	zfu
zfv	zfv
zfw	zfw
zfx	zfx
zfy	zfy
zfz	zfz
zga	zga
zgb	zgb
zgc	zgc
zgd	zgd
zge	zge
zgf	zgf
zgg	zgg
zgh	zgh
zgi	zgi
zgj	zgj
zgk	zgk
zgl	zgl
zgm	zgm
zgn	zgn
zgo	zgo
zgp	zgp
zgq	zgq
zgr	zgr
zgs	zgs
zgt	zgt
zgu	zgu
zgv	zgv
zgw	zgw
zgx	zgx
zgy	zgy
zgz	zgz
zha	zha
zhb	zhb
zhc	zhc
zhd	zhd
zhe	zhe
zhf	zhf
zhg	zhg
zhh	zhh
zhi	zhi
zhj	zhj
zhk	zhk
zhl	zhl
zhm	zhm
zhn	zhn
zho	zho
zhp	zhp
zhq	zhq
zhr	zhr
zhs	zhs
zht	zht
zhu	zhu
zhv	zhv
zhw	zhw
zhx	zhx
zhy	zhy
zhz	zhz
zia	zia
zib	zib
zic	zic
zid	zid
zie	zie
zif	zif
zig	zig
zih	zih
zii	zii
zij	zij
zik	zik
zil	zil
zim	zim
zin	zin
zio	zio
zip	zip
ziq	ziq
zir	zir
zis	zis
zit	zit
ziu	ziu
ziv	ziv
ziw	ziw
zix	zix
ziy	ziy
ziz	ziz
zja	zja
zjb	zjb
zjc	zjc
zjd	zjd
zje	zje
zjf	zjf
zjg	zjg
zjh	zjh
zji	zji
zjj	zjj
zjk	zjk
zjl	zjl
zjm	zjm
zjn	zjn
zjo	zjo
zjp	zjp
zjq	zjq
zjr	zjr
zjs	zjs
zjt	zjt
zju	zju
zjv	zjv
zjw	zjw
zjx	zjx
zjy	zjy
zjz	zjz
zka	zka
zkb	zkb
zkc	zkc
zkd	zkd
zke	zke
zkf	zkf
zkg	zkg
zkh	zkh
zki	zki
zkj	zkj
zkk	zkk
zkl	zkl
zkm	zkm
zkn	zkn
zko	zko
zkp	zkp
zkq	zkq
zkr	zkr
zks	zks
zkt	zkt
zku	zku
zkv	zkv
zkw	zkw
zkx	zkx
zky	zky
zkz	zkz
zla	zla
zlb	zlb
zlc	zlc
zld	zld
zle	zle
zlf	zlf
zlg	zlg
zlh	zlh
zli	zli
zlj	zlj
zlk	zlk
zll	zll
zlm	zlm
zln	zln
zlo	zlo
zlp	zlp
zlq	zlq
zlr	zlr
zls	zls
zlt	zlt
zlu	zlu
zlv	zlv
zlw	zlw
zlx	zlx
zly	zly
zlz	zlz
zma	zma
zmb	zmb
zmc	zmc
zmd	zmd
zme	zme
zmf	zmf
zmg	zmg
zmh	zmh
zmi	zmi
zmj	zmj
zmk	zmk
zml	zml
zmm	zmm
zmn	zmn
zmo	zmo
zmp	zmp
zmq	zmq
zmr	zmr
zms	zms
zmt	zmt
zmu	zmu
zmv	zmv
zmw	zmw
zmx	zmx
zmy	zmy
zmz	zmz
zna	zna
znb	znb
znc	znc
znd	znd
zne	zne
znf	znf
zng	zng
znh	znh
zni	zni
znj	znj
znk	znk
znl	znl
znm	znm
znn	znn
zno	zno
znp	znp
znq	znq
znr	znr
zns	zns
znt	znt
znu	znu
znv	znv
znw	znw
znx	znx
zny	zny
znz	znz
zoa	zoa
zob	zob
zoc	zoc
zod	zod
zoe	zoe
zof	zof
zog	zog
zoh	zoh
zoi	zoi
zoj	zoj
zok	zok
zol	zol
zom	zom
zon	zon
zoo	zoo
zop	zop
zoq	zoq
zor	zor
zos	zos
zot	zot
zou	zou
zov	zov
zow	zow
zox	zox
zoy	zoy
zoz	zoz
zpa	zpa
zpb	zpb
zpc	zpc
zpd	zpd
zpe	zpe
zpf	zpf
zpg	zpg
zph	zph
zpi	zpi
zpj	zpj
zpk	zpk
zpl	zpl
zpm	zpm
zpn	zpn
zpo	zpo
zpp	zpp
zpq	zpq
zpr	zpr
zps	zps
zpt	zpt
zpu	zpu
zpv	zpv
zpw	zpw
zpx	zpx
zpy	zpy
zpz	zpz
zqa	zqa
zqb	zqb
zqc	zqc
zqd	zqd
zqe	zqe
zqf	zqf
zqg	zqg
zqh	zqh
zqi	zqi
zqj	zqj
zqk	zqk
zql	zql
zqm	zqm
zqn	zqn
zqo	zqo
zqp	zqp
zqq	zqq
zqr	zqr
zqs	zqs
zqt	zqt
zqu	zqu
zqv	zqv
zqw	zqw
zqx	zqx
zqy	zqy
zqz	zqz
zra	zra
zrb	zrb
zrc	zrc
zrd	zrd
zre	zre
zrf	zrf
zrg	zrg
zrh	zrh
zri	zri
zrj	zrj
zrk	zrk
zrl	zrl
zrm	zrm
zrn	zrn
zro	zro
zrp	zrp
zrq	zrq
zrr	zrr
zrs	zrs
zrt	zrt
zru	zru
zrv	zrv
zrw	zrw
zrx	zrx
zry	zry
zrz	zrz
zsa	zsa
zsb	zsb
zsc	zsc
zsd	zsd
zse	zse
zsf	zsf
zsg	zsg
zsh	zsh
zsi	zsi
zsj	zsj
zsk	zsk
zsl	zsl
zsm	zsm
zsn	zsn
zso	zso
zsp	zsp
zsq	zsq
zsr	zsr
zss	zss
zst	zst
zsu	zsu
zsv	zsv
zsw	zsw
zsx	zsx
zsy	zsy
zsz	zsz
zta	zta
ztb	ztb
ztc	ztc
ztd	ztd
zte	zte
ztf	ztf
ztg	ztg
zth	zth
zti	zti
ztj	ztj
ztk	ztk
ztl	ztl
ztm	ztm
ztn	ztn
zto	zto
ztp	ztp
ztq	ztq
ztr	ztr
zts	zts
ztt	ztt
ztu	ztu
ztv	ztv
ztw	ztw
ztx	ztx
zty	zty
ztz	ztz
zua	zua
zub	zub
zuc	zuc
zud	zud
zue	zue
zuf	zuf
zug	zug
zuh	zuh
zui	zui
zuj	zuj
zuk	zuk
zul	zul
zum	zum
zun	zun
zuo	zuo
zup	zup
zuq	zuq
zur	zur
zus	zus
zut	zut
zuu	zuu
zuv	zuv
zuw	zuw
zux	zux
zuy	zuy
zuz	zuz
zva	zva
zvb	zvb
zvc	zvc
zvd	zvd
zve	zve
zvf	zvf
zvg	zvg
zvh	zvh
zvi	zvi
zvj	zvj
zvk	zvk
zvl	zvl
zvm	zvm
zvn	zvn
zvo	zvo
zvp	zvp
zvq	zvq
zvr	zvr
zvs	zvs
zvt	zvt
zvu	zvu
zvv	zvv
zvw	zvw
zvx	zvx
zvy	zvy
zvz	zvz
zwa	zwa
zwb	zwb
zwc	zwc
zwd	zwd
zwe	zwe
zwf	zwf
zwg	zwg
zwh	zwh
zwi	zwi
zwj	zwj
zwk	zwk
zwl	zwl
zwm	zwm
zwn	zwn
zwo	zwo
zwp	zwp
zwq	zwq
zwr	zwr
zws	zws
zwt	zwt
zwu	zwu
zwv	zwv
zww	zww
zwx	zwx
zwy	zwy
zwz	zwz
zxa	zxa
zxb	zxb
zxc	zxc
zxd	zxd
zxe	zxe
zxf	zxf
zxg	zxg
zxh	zxh
zxi	zxi
zxj	zxj
zxk	zxk
zxl	zxl
zxm	zxm
zxn	zxn
zxo	zxo
zxp	zxp
zxq	zxq
zxr	zxr
zxs	zxs
zxt	zxt
zxu	zxu
zxv	zxv
zxw	zxw
zxx	zxx
zxy	zxy
zxz	zxz
zya	zya
zyb	zyb
zyc	zyc
zyd	zyd
zye	zye
zyf	zyf
zyg	zyg
zyh	zyh
zyi	zyi
zyj	zyj
zyk	zyk
zyl	zyl
zym	zym
zyn	zyn
zyo	zyo
zyp	zyp
zyq	zyq
zyr	zyr
zys	zys
zyt	zyt
zyu	zyu
zyv	zyv
zyw	zyw
zyx	zyx
zyy	zyy
zyz	zyz
zza	zza
zzb	zzb
zzc	zzc
zzd	zzd
zze	zze
zzf	zzf
zzg	zzg
zzh	zzh
zzi	zzi
zzj	zzj
zzk	zzk
zzl	zzl
zzm	zzm
zzn	zzn
zzo	zzo
zzp	zzp
zzq	zzq
zzr	zzr
zzs	zzs
zzt	zzt
zzu	zzu
zzv	zzv
zzw	zzw
zzx	zzx
zzy	zzy
zzz	zzz
